,Team_1,Team_2,League_Rank_1,League_Rank_2,Games_played_1,Games_played_2,Points_1,Points_2,Won_1,Draw_1,Lost_1,Won_2,Draw_2,Lost_2,Goals_Scored_1,Goals_Scored_2,Goals_Rec_1,Goal_Rec_2,Goals_Diff_1,Goals_Diff_2,League_type_country,Large_Diff_win,Won_out_of_6,Avrage_FT_Goal,Average_HT_Goal,Results_1,Results_2,H2H_Side,H2H_Outcome,H2H_Goals_Home,H2H_Goals_Away,Goals_scored_diff,Goals_Rec_diff,Goals_Diff_diff
0,manchester c,liverpool,3,1,20,20,47,54,15,2,3,17,3,0,54,48,16,8,38,40,england,0,4,3.5,1.33,2,1,A,D,0,0,6,8,-2
1,newcastle,manchester u,15,6,20,20,18,35,4,6,10,10,5,5,15,41,27,32,-12,9,england,0,0,3.0,1.33,0,2,A,L,2,3,-26,-5,-21
2,brighton,liverpool,13,1,21,21,26,54,7,5,9,17,3,1,24,49,29,10,-5,39,england,0,5,4.2,1.8,0,1,A,L,0,1,-25,19,-44
3,manchester united,brighton and hove albion,6,13,22,22,41,26,12,5,5,7,5,10,44,24,32,30,12,-6,england,0,0,2.25,1.25,2,1,A,L,2,3,20,2,18
4,chelsea,newcastle,4,15,21,21,44,18,13,5,3,4,6,11,38,15,16,29,22,-14,england,0,4,3.83,1.66,2,1,A,W,2,1,23,-13,36
5,liverpool,crystal palace,1,14,22,22,57,22,18,3,1,6,4,12,50,20,10,28,40,-8,england,0,5,2.83,1.5,4,3,A,W,2,0,30,-18,48
6,chelsea,southampton,4,17,20,20,43,15,13,4,3,3,6,11,38,21,16,38,22,-17,england,3,6,3.16,1.16,0,0,A,W,3,0,17,-22,39
8,west ham,arsenal,10,5,21,21,28,41,8,4,9,12,5,4,29,46,32,31,-3,15,england,0,5,3.16,0.66,1,0,A,L,1,3,-17,1,-18
10,fulham,tottenham,19,3,22,22,14,48,3,5,14,16,0,6,20,46,49,22,-29,24,england,0,5,3.0,0.66,1,2,A,L,1,3,-26,27,-53
11,manchester c,wolverhampton,2,11,21,21,50,29,16,2,3,8,5,8,56,23,17,25,39,-2,england,0,4,4.5,1.16,3,0,A,D,1,1,33,-8,41
13,cardiff,tottenham,16,3,20,20,18,45,5,3,12,15,0,5,19,43,38,21,-19,22,england,0,4,1.4,1.0,0,3,A,L,0,1,-24,17,-41
17,everton,afc bournemouth,11,12,21,21,27,27,7,6,8,8,3,10,31,31,31,40,0,-9,england,0,0,3.83,1.16,2,0,A,D,2,2,0,-9,9
18,huddersfield town,manchester city,20,2,22,22,11,53,2,5,15,17,2,3,13,59,37,17,-24,42,england,5,0,3.2,1.8,0,3,A,L,1,6,-46,20,-66
19,arsenal,chelsea,5,4,22,22,41,47,12,5,5,14,5,3,46,40,32,17,14,23,england,0,-4,4.16,1.16,2,0,A,L,2,3,6,15,-9
23,wolverhampton,crystal palace,8,14,20,20,29,19,8,5,7,5,4,11,23,17,23,26,0,-9,england,0,0,2.83,0.66,0,2,A,W,1,0,6,-3,9
29,west ham,brighton,11,13,20,20,27,25,8,3,9,7,4,9,27,22,30,27,-3,-5,england,0,0,3.0,1.5,2,2,A,L,0,1,5,3,2
30,arsenal,fulham,5,19,20,20,38,14,11,5,4,3,5,12,42,18,30,43,12,-25,england,4,4,3.66,1.66,4,1,A,W,5,1,24,-13,37
32,leicester,southampton,7,18,21,21,31,16,9,4,8,3,7,11,25,21,23,38,2,-17,england,0,0,1.83,0.83,1,2,H,D,0,0,4,-15,19
33,burnley,fulham,16,19,21,21,18,14,5,3,13,3,5,13,21,19,42,47,-21,-28,england,0,0,3.5,2.0,2,1,A,L,2,4,2,-5,7
38,huddersfield,burnley,20,18,20,20,10,15,2,4,14,4,3,13,12,19,35,41,-23,-22,england,0,0,2.33,1.66,1,2,A,D,1,1,-7,-6,-1
43,afc bournemouth,west ham united,12,9,22,22,27,31,8,3,11,9,4,9,31,30,42,32,-11,-2,england,0,0,3.5,1.0,2,0,A,W,2,1,1,10,-9
44,wolverhampton,leicester,11,8,22,22,29,31,8,5,9,9,4,9,23,26,28,25,-5,1,england,0,0,2.33,1.0,4,3,H,L,1,3,-3,3,-6
48,southampton,everton,16,10,22,22,19,30,4,7,11,8,6,8,23,33,39,31,-16,2,england,0,0,2.83,1.0,2,1,A,W,2,1,-10,8,-18
50,bournemouth,watford,12,9,20,20,26,28,8,2,10,8,4,8,28,27,37,28,-9,-1,england,4,-4,3.0,1.16,3,3,A,W,4,0,1,9,-8
58,watford,burnley,7,15,22,22,32,21,9,5,8,6,3,13,32,23,32,43,0,-20,england,0,0,2.5,1.16,0,0,A,W,3,1,9,-11,20
59,cardiff,huddersfield,17,20,21,21,18,10,5,3,13,2,4,15,19,13,41,37,-22,-24,england,0,4,2.5,1.33,0,0,A,D,0,0,6,4,2
62,newcastle,cardiff,18,17,22,22,18,19,4,6,12,5,4,13,16,19,31,41,-15,-22,england,0,4,2.33,0.83,3,0,A,D,0,0,-3,-10,7
64,crystal palace,watford,14,8,21,21,22,29,6,4,11,8,5,8,19,30,26,31,-7,-1,england,0,0,2.0,0.5,1,2,A,L,1,2,-11,-5,-6
81,bolton,west bromwich,23,4,27,27,22,47,5,7,15,13,8,6,18,55,40,35,-22,20,england,0,0,2.66,1.0,0,2,A,W,2,1,-37,5,-42
94,everton,leicester city,10,8,20,20,27,28,7,6,7,8,4,8,31,24,30,23,1,1,england,0,4,3.16,1.83,0,1,A,W,2,1,7,7,0
104,norwich,birmingham,3,8,27,27,50,39,14,8,5,9,12,6,49,39,35,30,14,9,england,0,0,2.0,0.83,3,1,A,D,2,2,10,5,5
110,leeds,derby,1,6,26,26,51,43,15,6,5,12,7,7,44,38,28,32,16,6,england,3,0,3.0,1.5,2,0,A,W,4,1,6,-4,10
132,aston villa,queens pr,9,8,25,25,37,38,9,10,6,11,5,9,47,31,38,32,9,-1,england,0,0,2.66,1.5,2,2,A,L,0,1,16,6,10
136,nottingham forest,leeds,10,1,25,25,36,51,8,12,5,15,6,4,35,42,27,24,8,18,england,0,0,1.83,0.5,4,2,A,D,1,1,-7,3,-10
145,aston villa,ipswich,13,24,28,28,39,18,9,12,7,3,9,16,51,22,45,48,6,-26,england,0,0,2.0,0.83,2,1,A,D,1,1,29,-3,32
152,middlesbrough,millwall,5,20,27,27,46,28,12,10,5,7,7,13,30,33,19,43,11,-10,england,0,0,3.5,2.16,1,1,A,D,2,2,-3,-24,21
156,hull,bolton,14,21,25,25,33,22,9,6,10,5,7,13,30,17,33,32,-3,-15,england,0,0,2.16,1.5,6,0,A,W,1,0,13,1,12
157,brentford,norwich,18,2,25,25,27,48,6,9,10,14,6,5,35,47,35,33,0,14,england,0,4,2.33,1.16,1,1,A,L,0,1,-12,2,-14
164,blackburn,west bromwich,15,3,25,25,31,46,7,10,8,13,7,5,31,53,40,32,-9,21,england,0,0,2.33,0.83,2,1,A,D,1,1,-22,8,-30
165,norwich,sheffield u,2,4,28,28,53,50,15,8,5,15,5,8,52,46,36,29,16,17,england,0,0,2.83,1.33,2,2,A,L,1,2,6,7,-1
182,rotherham,leeds,21,1,28,28,25,54,5,10,13,16,6,6,27,47,46,30,-19,17,england,0,0,2.33,0.66,1,2,A,L,0,2,-20,16,-36
186,afc wimbledon,fleetwood,24,8,29,29,23,39,6,5,18,10,9,10,22,40,44,33,-22,7,england,0,0,2.16,0.66,0,3,A,W,3,2,-18,11,-29
188,derby,reading,6,22,27,27,43,23,12,7,8,5,8,14,38,30,34,41,4,-11,england,0,0,4.0,1.66,2,1,A,W,2,1,8,-7,15
193,derby,middlesbrough,6,5,25,25,42,42,12,6,7,11,9,5,37,27,31,17,6,10,england,0,0,2.16,0.66,1,1,A,D,1,1,10,14,-4
194,wigan,sheffield u,19,4,25,25,26,44,7,5,13,13,5,7,25,42,37,28,-12,14,england,0,0,3.33,1.66,0,3,A,L,2,4,-17,9,-26
195,ipswich,millwall,24,20,25,25,15,25,2,9,14,6,7,12,19,30,43,39,-24,-9,england,3,0,3.5,2.0,2,3,A,L,0,3,-11,4,-15
196,blackburn,hull,8,12,29,29,43,40,11,10,8,11,7,11,40,41,41,38,-1,3,england,3,0,1.83,0.5,3,0,H,W,3,0,-1,3,-4
206,blackburn,ipswich,14,24,27,27,37,18,9,10,8,3,9,15,35,22,41,46,-6,-24,england,0,0,3.0,1.66,2,0,A,D,2,2,13,-5,18
207,aston villa,hull,12,10,27,27,38,39,9,11,7,11,6,10,49,39,43,33,6,6,england,0,0,2.5,1.66,2,2,A,W,3,1,10,10,0
210,bristol city,bolton,11,22,26,26,38,22,10,8,8,5,7,14,32,17,28,38,4,-21,england,0,0,2.66,0.66,2,1,A,D,2,2,15,-10,25
216,lincoln,port vale,1,17,24,25,50,28,15,5,4,7,7,11,44,25,23,32,21,-7,england,4,4,3.5,1.16,1,1,A,W,6,2,19,-9,28
218,stoke,preston,15,18,28,28,38,33,9,11,8,8,9,11,33,43,35,45,-2,-2,england,0,0,2.83,1.66,0,2,A,D,2,2,-10,-10,0
221,plymouth,walsall,17,15,29,29,33,35,9,6,14,9,8,12,38,33,51,45,-13,-12,england,0,0,2.5,0.66,2,1,H,W,2,1,5,6,-1
237,sheffield u,queens pr,3,9,26,26,47,39,14,5,7,11,6,9,45,33,28,34,17,-1,england,0,0,2.66,1.5,1,0,A,W,2,1,12,-6,18
238,wigan,aston villa,20,10,26,26,26,38,7,5,14,9,11,6,25,49,40,40,-15,9,england,0,4,3.33,1.66,3,0,A,L,2,3,-24,0,-24
246,peterborough,scunthorpe,5,22,25,25,44,24,12,8,5,6,6,13,45,30,31,51,14,-21,england,0,0,2.5,0.83,0,2,A,W,2,0,15,-20,35
247,portsmouth,afc wimbledon,1,23,25,25,54,22,16,6,3,6,4,15,44,19,23,35,21,-16,england,0,4,2.0,0.83,2,1,A,W,2,1,25,-12,37
249,forest green,grimsby,7,15,27,28,44,34,11,11,5,10,4,14,40,29,27,35,13,-6,england,3,4,2.66,1.0,3,0,A,W,4,1,11,-8,19
252,swansea,sheffield u,13,3,27,27,37,50,10,7,10,15,5,7,36,46,32,28,4,18,england,0,0,2.33,0.5,1,0,A,W,2,1,-10,4,-14
253,nottingham forest,bristol city,8,7,27,27,39,41,9,12,6,11,8,8,39,34,31,29,8,5,england,0,0,2.0,1.0,0,1,A,D,1,1,5,2,3
257,mansfield,crawley town,5,17,26,27,45,33,11,12,3,10,3,14,37,34,20,40,17,-6,england,0,0,2.83,0.83,1,0,H,D,1,1,3,-20,23
261,brentford,stoke city,18,14,26,26,28,35,6,10,10,8,11,7,36,30,36,31,0,-1,england,0,0,2.0,1.0,3,1,A,D,1,1,6,5,1
263,millwall,blackburn,19,15,27,27,29,35,7,8,12,8,11,8,33,33,41,41,-8,-8,england,0,0,3.0,0.66,0,2,A,D,0,0,0,0,0
269,macclesfield,tranmere,23,9,25,25,20,38,5,5,15,10,8,7,21,37,41,31,-20,6,england,0,0,3.16,1.33,1,1,A,L,0,1,-16,10,-26
270,blackpool,sunderland,8,3,24,23,35,47,9,8,7,13,8,2,26,44,24,23,2,21,england,0,0,2.5,1.0,0,1,H,L,1,2,-18,1,-19
271,sheffield w,birmingham,16,7,25,25,31,38,8,7,10,9,11,5,31,37,41,27,-10,10,england,0,4,3.0,1.16,1,1,A,L,1,3,-6,14,-20
272,rotherham,preston,22,17,25,25,22,29,4,10,11,7,8,10,23,37,40,41,-17,-4,england,0,0,2.5,1.5,2,1,A,D,1,1,-14,-1,-13
274,nottingham forest,wigan,9,20,29,29,42,29,10,12,7,8,5,16,42,29,33,44,9,-15,england,0,0,3.33,1.5,3,1,H,W,3,1,13,-11,24
278,barnsley,rochdale,5,20,27,29,52,31,15,7,5,8,7,14,47,35,23,59,24,-24,england,4,0,3.66,1.0,2,1,A,W,4,0,12,-36,48
289,queens pr,preston,11,18,27,27,39,30,11,6,10,7,9,11,33,39,35,44,-2,-5,england,0,4,2.0,1.0,1,4,A,L,0,1,-6,-9,3
290,rotherham,brentford,21,17,27,27,25,31,5,10,12,7,10,10,25,39,42,37,-17,2,england,4,0,3.33,1.16,2,4,A,L,1,5,-14,5,-19
298,west bromwich,norwich,4,2,26,26,46,49,13,7,6,14,7,5,54,48,34,34,20,14,england,0,0,2.5,0.66,1,1,A,W,4,3,6,0,6
299,reading,nottingham forest,23,7,26,26,20,39,4,8,14,9,12,5,28,39,41,29,-13,10,england,0,0,2.83,0.83,2,0,A,L,0,1,-11,12,-23
300,preston,swansea,17,12,26,26,29,36,7,8,11,10,6,10,38,35,43,31,-5,4,england,0,4,2.83,1.66,1,1,A,L,0,1,3,12,-9
301,birmingham,middlesbrough,8,5,26,26,39,43,9,12,5,11,10,5,38,28,28,18,10,10,england,0,0,1.66,1.16,1,2,A,L,0,1,10,10,0
309,southend,luton,11,2,28,28,38,56,12,2,14,16,8,4,38,54,34,25,4,29,england,0,0,3.16,1.0,0,1,A,W,5,3,-16,9,-25
330,oxford united,portsmouth,23,1,26,27,26,57,6,8,12,17,6,4,31,46,41,25,-10,21,england,3,0,2.33,0.33,2,1,A,L,1,4,-15,16,-31
340,ipswich,rotherham,24,21,26,26,15,25,2,9,15,5,10,11,21,25,46,41,-25,-16,england,0,4,2.66,1.16,1,0,A,L,0,1,-4,5,-9
350,bromley,wrexham,13,3,28,28,36,53,10,6,12,15,8,5,40,36,43,18,-3,18,england,0,0,3.33,1.0,2,0,A,D,2,2,4,25,-21
354,morecambe,crewe,20,15,26,26,26,31,7,5,14,9,4,13,26,25,42,32,-16,-7,england,6,4,2.0,1.0,2,2,A,L,0,6,1,10,-9
355,crawley town,cheltenham,17,18,25,25,30,29,9,3,13,7,8,10,32,31,38,37,-6,-6,england,0,0,3.33,1.16,1,0,A,W,1,0,1,1,0
358,wycombe wanderers,coventry city,13,9,25,25,32,35,8,8,9,10,5,10,34,26,36,29,-2,-3,england,0,6,2.83,1.0,0,2,A,L,0,1,8,7,1
361,peterborough,charlton,6,4,28,29,47,53,13,8,7,16,5,8,47,47,38,31,9,16,england,0,0,3.16,0.66,0,0,A,W,1,0,0,7,-7
379,lincoln,grimsby,1,15,26,27,52,34,15,7,4,10,4,13,47,29,26,34,21,-5,england,0,0,2.33,1.66,1,0,A,D,1,1,18,-8,26
384,exeter,morecambe,8,21,27,28,44,28,12,8,7,7,7,14,38,28,28,44,10,-16,england,0,4,2.83,1.66,0,0,H,D,0,0,10,-16,26
385,portsmouth,blackpool,1,9,27,26,57,38,17,6,4,10,8,8,46,27,25,25,21,2,england,0,0,2.66,0.83,0,1,H,L,0,1,19,0,19
390,gateshead,solihull,8,3,29,29,46,54,14,4,11,16,6,7,37,45,29,26,8,19,england,0,0,2.16,0.66,1,2,H,L,1,2,-8,3,-11
395,macclesfield,swindon,23,14,26,26,21,33,5,6,15,8,9,9,22,27,42,34,-20,-7,england,0,0,2.66,0.33,1,2,A,L,2,3,-5,8,-13
403,leyton orient,dagenham and redbridge,1,14,27,27,54,34,15,9,3,10,4,13,48,30,17,33,31,-3,england,0,0,1.83,0.33,1,0,A,L,1,2,18,-16,34
404,reading,swansea,23,13,25,25,20,33,4,8,13,9,6,10,27,31,37,30,-10,1,england,0,0,2.33,1.0,1,4,A,L,0,2,-4,7,-11
405,bristol rovers,burton albion,19,15,25,24,26,31,7,5,13,9,4,11,25,30,29,33,-4,-3,england,0,0,2.83,0.5,0,0,A,L,0,1,-5,-4,-1
407,crewe,colchester,14,7,29,29,38,46,11,5,13,13,7,9,31,44,36,33,-5,11,england,6,0,3.16,1.16,2,1,A,L,0,6,-13,3,-16
408,mansfield town,tranmere rovers,2,10,29,29,54,42,14,12,3,11,9,9,44,42,22,38,22,4,england,3,0,1.2,0.8,3,0,H,W,3,0,2,-16,18
415,northampton,morecambe,16,22,28,29,33,28,7,12,9,7,7,15,37,29,38,46,-1,-17,england,0,4,2.83,1.5,1,1,A,L,0,1,8,-8,16
425,bradford,southend,21,11,27,27,27,35,8,3,16,11,2,14,31,34,43,34,-12,0,england,0,0,2.16,0.66,0,4,A,L,0,2,-3,9,-12
426,blackpool,shrewsbury town,9,17,26,27,38,30,10,8,8,7,9,11,27,29,25,35,2,-6,england,0,0,2.66,0.83,0,0,A,D,0,0,-2,-10,8
429,milton keynes dons,crewe,4,14,26,28,47,35,13,8,5,10,5,13,44,30,23,36,21,-6,england,0,0,3.0,1.66,0,1,A,D,0,0,14,-13,27
443,blackburn rovers am,derby county am,11,3,13,14,15,23,4,3,6,7,2,5,17,20,23,17,-6,3,england,0,0,3.2,1.8,1,3,A,D,2,2,-3,6,-9
445,peterborough,rochdale,7,18,26,27,44,30,12,8,6,8,6,13,45,33,33,56,12,-23,england,3,0,3.33,2.83,2,1,A,W,4,1,12,-23,35
446,bury,milton keynes dons,3,2,27,25,46,47,13,7,7,13,8,4,49,41,29,19,20,22,england,0,0,2.0,0.66,4,3,A,L,0,1,8,10,-2
476,fleetwood,scunthorpe,8,16,29,29,39,34,10,9,10,9,7,13,41,37,33,54,8,-17,england,5,0,3.5,2.0,0,1,A,W,5,0,4,-21,25
477,wycombe,plymouth,12,17,28,29,38,33,10,8,10,9,6,14,38,38,40,51,-2,-13,england,0,0,2.83,1.83,1,0,A,D,1,1,0,-11,11
479,coventry,blackpool,10,9,29,27,39,39,11,6,12,10,9,8,31,27,34,25,-3,2,england,0,0,2.0,0.33,0,2,A,L,0,2,4,9,-5
480,burton albion,bradford,13,23,28,28,36,27,10,6,12,8,3,17,38,31,38,47,0,-16,england,0,0,2.83,1.66,1,1,A,L,0,1,7,-9,16
481,swindon,crawley town,11,17,29,29,40,33,10,10,9,10,3,16,33,34,38,42,-5,-8,england,0,0,2.5,0.83,0,1,A,D,2,2,-1,-4,3
483,stevenage,forest green,9,6,29,28,44,47,13,5,11,12,11,5,35,43,36,27,-1,16,england,0,0,2.0,1.16,0,2,A,D,0,0,-8,9,-17
484,exeter,cambridge,8,19,28,29,44,32,12,8,8,9,5,15,38,28,29,49,9,-21,england,0,0,2.16,1.16,1,0,A,W,2,0,10,-20,30
519,morecambe,stevenage,21,10,28,28,28,41,7,7,14,12,5,11,28,33,44,35,-16,-2,england,0,4,2.33,1.33,1,2,A,L,0,1,-5,9,-14
520,gillingham,walsall,19,16,26,27,28,32,8,4,14,8,8,11,36,29,43,43,-7,-14,england,0,0,2.0,1.0,0,3,A,L,1,2,7,0,7
525,bristol rovers,wycombe,22,11,28,28,28,38,7,7,14,10,8,10,25,38,30,40,-5,-2,england,0,4,2.66,1.16,0,1,H,L,0,1,-13,-10,-3
536,arsenal am,manchester city am,9,7,14,14,17,20,4,5,5,6,2,6,25,27,32,32,-7,-5,england,0,0,5.5,2.5,5,1,A,L,5,6,-2,0,-2
537,swansea cit,23 - leicester city-u23,12,1,14,14,11,24,2,5,7,7,3,4,20,19,26,12,-6,7,england,0,0,2.33,1.33,0,3,A,L,0,1,1,14,-13
550,crewe alexandra,newport county,16,13,27,25,32,36,9,5,13,10,6,9,27,35,34,42,-7,-7,england,0,0,2.2,1.2,3,2,A,L,0,1,-8,-8,0
551,cheltenham,tranmere,18,9,26,26,29,39,7,8,11,10,9,7,31,38,38,32,-7,6,england,0,4,1.83,1.0,1,3,A,L,0,1,-7,6,-13
560,norwich am,aston villa am,10,5,15,15,15,23,4,3,8,7,2,6,21,26,31,26,-10,0,england,0,0,2.16,1.16,2,1,H,W,2,1,-5,5,-10
561,wolverhampton wanderers am,reading am,2,1,14,15,27,30,8,3,3,9,3,3,32,34,15,23,17,11,england,0,0,2.83,1.5,1,2,H,L,1,2,-2,-8,6
565,woking,welling united,2,6,22,24,49,41,15,4,3,12,5,7,47,43,24,28,23,15,england,0,0,2.5,0.5,2,0,H,W,1,0,4,-4,8
571,aston vill,23 - manchester united-u23,5,4,14,14,23,25,7,2,5,7,4,3,25,21,24,17,1,4,england,4,0,3.33,1.0,5,1,H,W,5,1,4,7,-3
581,cambridge,stevenage,21,11,27,27,26,38,7,5,15,11,5,11,24,31,47,34,-23,-3,england,0,5,1.5,0.66,2,0,H,W,2,0,-7,13,-20
587,wrexham,dover athletic,2,18,27,28,53,28,15,8,4,7,7,14,36,29,17,46,19,-17,england,0,0,0.83,0.33,0,1,A,W,1,0,7,-29,36
588,scunthorpe,coventry,17,8,27,27,30,38,8,6,13,11,5,11,34,29,52,31,-18,-2,england,0,6,2.5,0.33,2,1,H,W,2,1,5,21,-16
591,colchester,notts county,8,24,27,27,43,21,12,7,8,4,9,14,39,29,30,56,9,-27,england,0,0,3.33,1.83,3,3,H,D,3,3,10,-26,36
594,southampton am,stoke am,4,8,13,13,24,16,7,3,3,4,4,5,18,26,11,23,7,3,england,3,4,2.66,1.16,2,0,A,W,4,1,-8,-12,4
599,arsenal,leicester,5,11,8,8,18,12,6,0,2,4,0,4,19,14,10,12,9,2,england,0,4,3.66,1.5,3,1,A,L,1,3,5,-2,7
602,tottenham,manchester c,5,3,9,9,21,23,7,0,2,7,2,0,16,26,7,3,9,23,england,0,0,3.5,1.16,0,1,H,L,1,3,-10,4,-14
603,crystal palace,arsenal,15,4,9,9,7,21,2,1,6,7,0,2,5,22,11,11,-6,11,england,3,4,3.33,1.66,2,2,A,L,1,4,-17,0,-17
604,burnley,chelsea,14,3,9,9,8,21,2,2,5,6,3,0,10,20,17,7,-7,13,england,0,0,3.16,2.16,0,4,H,L,1,2,-10,10,-20
606,chelsea,manchester u,2,8,8,8,20,13,6,2,0,4,1,3,18,13,5,14,13,-1,england,0,4,2.0,1.0,2,2,H,W,1,0,5,-9,14
610,manchester u,everton,10,8,9,9,14,15,4,2,3,4,3,2,15,15,16,12,-1,3,england,0,4,2.33,0.66,2,1,A,W,2,0,0,4,-4
614,everton,crystal palace,11,14,8,8,12,7,3,3,2,2,1,5,13,5,12,9,1,-4,england,0,-4,2.16,0.83,2,0,H,W,3,1,8,3,5
637,west ham,tottenham,15,5,8,8,7,18,2,1,5,6,0,2,8,15,13,7,-5,8,england,0,0,3.16,1.0,0,1,A,D,1,1,-7,6,-13
638,leicester,west ham,11,14,9,9,12,7,4,0,5,2,1,6,15,8,15,14,0,-6,england,0,0,2.83,1.83,1,1,H,L,0,2,7,1,6
642,manchester c,burnley,1,12,8,8,20,8,6,2,0,2,2,4,21,10,3,12,18,-2,england,0,4,2.83,0.83,5,0,A,D,1,1,11,-9,20
644,afc bournemouth,crystal palace,9,13,6,6,10,7,3,1,2,2,1,3,10,4,11,6,-1,-2,england,0,-4,2.5,1.16,2,1,H,D,2,2,6,5,1
646,watford,huddersfield,7,19,9,9,16,3,5,1,3,0,3,6,13,4,12,18,1,-14,england,0,4,4.0,1.0,3,0,A,L,0,1,9,-6,15
660,brighton,wolverhampton,12,9,9,9,11,15,3,2,4,4,3,2,10,9,13,8,-3,1,england,0,0,1.33,0.66,1,0,A,W,2,0,1,5,-4
684,southampton,newcastle,16,20,9,9,6,2,1,3,5,0,2,7,6,6,14,14,-8,-8,england,3,0,3.66,1.83,0,0,A,L,0,3,0,0,0
710,leeds,nottingham forest,2,8,14,14,26,22,7,5,2,5,7,2,25,21,11,15,14,6,england,0,0,1.83,0.5,1,1,H,D,0,0,4,-4,8
746,sheffield u,wigan,3,13,14,14,26,20,8,2,4,6,2,6,23,16,16,18,7,-2,england,0,4,3.0,1.66,4,2,H,L,0,2,7,-2,9
747,west bromwich,blackburn,4,10,14,14,24,21,7,3,4,5,6,3,32,17,22,19,10,-2,england,3,0,2.66,0.83,1,1,H,W,3,0,15,3,12
756,sheffield w,middlesbrough,6,4,12,12,19,22,5,4,3,6,4,2,19,14,18,6,1,8,england,0,4,2.16,0.5,1,2,A,D,0,0,5,12,-7
759,tranmere rovers,macclesfield town,7,24,12,12,20,4,5,5,2,0,4,8,16,11,12,23,4,-12,england,3,0,3.16,1.33,1,0,H,L,1,4,5,-11,16
761,brentford,birmingham city,6,16,10,10,16,10,4,4,2,1,7,2,18,9,12,10,6,-1,england,5,0,3.16,0.66,1,1,H,W,5,0,9,2,7
762,ipswich,middlesbrough,22,3,10,10,6,19,0,6,4,5,4,1,8,12,14,4,-6,8,england,0,0,2.5,1.16,0,2,H,D,2,2,-4,10,-14
763,aston villa,preston north end,15,24,10,10,14,5,3,5,2,1,2,7,16,11,15,21,1,-10,england,0,0,2.5,1.75,3,3,H,D,1,1,5,-6,11
764,wigan,swansea,8,7,10,10,16,16,5,1,4,4,4,2,14,10,12,6,2,4,england,0,0,2.4,0.4,0,0,H,L,2,3,4,6,-2
779,leeds,ipswich,5,24,13,13,23,9,6,5,2,1,6,6,23,11,11,20,12,-9,england,0,0,2.16,1.33,2,0,A,L,0,1,12,-9,21
781,middlesbrough,rotherham united,1,20,13,13,25,12,7,4,2,3,3,7,16,10,7,20,9,-10,england,0,0,1.75,0.75,0,0,A,L,0,1,6,-13,19
789,derby,sheffield u,8,2,12,12,18,25,5,3,4,8,1,3,15,21,13,13,2,8,england,0,0,1.83,1.0,2,1,H,D,1,1,-6,0,-6
801,stoke,bolton,17,14,10,10,10,15,2,4,4,4,3,3,14,10,18,12,-4,-2,england,0,0,3.66,1.83,2,0,H,D,2,2,4,6,-2
802,hull,leeds,21,2,10,10,8,19,2,2,6,5,4,1,10,20,17,8,-7,12,england,0,0,2.5,1.5,0,1,H,D,0,0,-10,9,-19
835,middlesbrough,derby,2,5,14,14,26,24,7,5,2,7,3,4,16,21,7,15,9,6,england,0,4,2.16,0.66,1,1,A,W,2,1,-5,-8,3
838,bolton,hull,18,23,14,14,16,9,4,4,6,2,3,9,11,11,19,21,-8,-10,england,0,0,2.66,1.66,0,1,H,W,1,0,0,-2,2
839,millwall,ipswich,20,24,14,14,13,9,3,4,7,1,6,7,16,11,23,22,-7,-11,england,0,4,3.5,1.83,3,0,A,D,2,2,5,1,4
840,swansea,reading,11,22,14,14,20,12,5,5,4,3,3,8,15,19,11,23,4,-4,england,0,0,3.0,1.33,2,0,A,W,2,0,-4,-12,8
849,west bromwich,derby,3,6,13,13,24,21,7,3,3,6,3,4,31,17,18,14,13,3,england,0,0,2.66,0.5,1,4,H,L,1,2,14,4,10
850,preston,brentford,22,15,13,13,10,18,2,4,7,4,6,3,19,20,25,15,-6,5,england,0,4,4.16,1.5,4,3,A,D,1,1,-1,10,-11
860,hull,preston,24,22,12,12,8,9,2,2,8,2,3,7,10,18,19,24,-9,-6,england,0,0,2.0,1.16,1,1,A,L,1,2,-8,-5,-3
872,afc wimbledon,portsmouth,20,1,12,12,11,27,3,2,7,8,3,1,9,21,16,10,-7,11,england,0,0,1.66,0.66,1,2,A,W,2,1,-12,6,-18
908,norwich,brentford,6,15,14,14,24,18,7,3,4,4,6,4,19,23,17,19,2,4,england,0,4,2.66,1.33,1,0,A,W,1,0,-4,-2,-2
909,preston,rotherham,19,21,14,14,13,13,3,4,7,3,4,7,23,10,28,20,-5,-10,england,0,0,2.5,1.5,1,1,H,D,1,1,13,8,5
915,queens pr,aston villa,13,16,14,14,20,18,6,2,6,4,6,4,14,22,19,22,-5,0,england,0,0,2.83,1.5,1,0,A,W,3,1,-8,-3,-5
922,bolton,nottingham forest,18,12,13,13,16,19,4,4,5,4,7,2,11,18,16,15,-5,3,england,0,0,4.0,1.83,0,3,H,W,3,2,-7,1,-8
924,portsmouth,burton albion,1,14,14,13,33,17,10,3,1,5,2,6,24,16,11,17,13,-1,england,0,0,1.75,0.75,2,2,H,D,1,1,8,-6,14
925,birmingham,reading,14,19,13,13,17,12,3,8,2,3,3,7,14,18,12,21,2,-3,england,0,0,1.5,0.66,2,1,A,L,0,2,-4,-9,5
926,swansea,blackburn,15,7,13,13,17,21,4,5,4,5,6,2,12,16,10,16,2,0,england,0,0,4.33,2.33,3,1,A,L,1,3,-4,-6,2
948,ipswich,queens pr,23,18,12,12,9,14,1,6,5,4,2,6,11,9,18,19,-7,-10,england,0,0,2.16,0.66,0,2,H,D,0,0,2,-1,3
953,wigan,west bromwich,12,3,12,12,17,24,5,2,5,7,3,2,14,31,16,17,-2,14,england,0,0,3.0,1.66,1,0,A,W,3,2,-17,-1,-16
954,brentford,bristol city,7,13,12,12,18,16,4,6,2,4,4,4,20,16,14,14,6,2,england,0,4,2.66,1.33,0,1,A,W,1,0,4,0,4
976,reading,queens pr,20,19,10,10,9,10,2,3,5,3,1,6,14,7,15,18,-1,-11,england,0,0,1.5,1.16,0,1,H,W,1,0,7,-3,10
977,accrington stanley,doncaster rovers,8,3,10,10,17,21,4,5,1,6,3,1,13,18,11,9,2,9,england,0,0,3.5,1.75,1,0,A,D,2,2,-5,2,-7
978,tranmere,lincoln,16,1,10,10,14,25,3,5,2,8,1,1,11,20,9,7,2,13,england,0,4,2.0,1.0,1,0,A,L,1,2,-9,2,-11
979,exeter,stevenage,3,4,10,10,20,18,6,2,2,5,3,2,19,12,10,9,9,3,england,0,0,3.16,1.16,1,0,A,L,1,3,7,1,6
991,crewe alexandra,mansfield town,17,11,15,14,19,21,5,4,6,4,9,1,16,18,14,10,2,8,england,0,0,4.0,1.75,0,3,A,W,4,3,-2,4,-6
1044,peterborough united,fleetwood town,2,13,15,15,30,20,9,3,3,5,5,5,31,21,20,14,11,7,england,0,0,2.5,0.83,1,0,H,W,1,0,10,6,4
1045,blackpool,scunthorpe,13,15,12,14,19,17,4,7,1,4,5,5,14,22,9,29,5,-7,england,0,4,3.66,1.33,1,0,H,L,2,3,-8,-20,12
1046,queens pr,sheffield w,16,11,13,13,17,19,5,2,6,5,4,4,11,20,19,20,-8,0,england,0,0,2.33,1.33,3,0,H,W,4,2,-9,-1,-8
1047,millwall,wigan,22,8,13,13,10,20,2,4,7,6,2,5,14,15,22,16,-8,-1,england,0,0,1.66,0.33,2,1,H,D,0,0,-1,6,-7
1048,norwich,aston villa,6,13,13,13,21,18,6,3,4,4,6,3,17,21,16,20,1,1,england,0,0,2.83,1.0,2,1,H,W,3,1,-4,-4,0
1052,aston vill,21 - newcastle united-u21,4,9,7,7,15,7,5,0,2,2,1,4,9,14,8,12,1,2,england,0,0,3.33,1.83,2,5,A,L,0,2,-5,-4,-1
1073,reading,millwall,21,20,12,12,9,10,2,3,7,2,4,6,15,13,20,19,-5,-6,england,0,0,2.83,1.0,3,1,H,L,0,2,2,1,1
1074,aston villa,swansea,15,11,12,12,15,17,3,6,3,4,5,3,20,12,20,9,0,3,england,0,5,2.16,1.0,1,0,A,L,0,1,8,11,-3
1075,rotherham united,bolton wanderers,19,16,12,12,11,15,3,2,7,4,3,5,9,10,19,15,-10,-5,england,0,0,4.5,1.5,1,1,A,L,1,2,-1,4,-5
1076,nottingham forest,norwich,6,10,12,12,19,18,4,7,1,5,3,4,17,15,13,15,4,0,england,0,0,2.83,1.0,1,2,A,D,0,0,2,-2,4
1081,blackburn,leeds,10,4,12,12,18,23,4,6,2,6,5,1,14,22,15,9,-1,13,england,0,4,2.5,0.5,2,1,H,L,1,2,-8,6,-14
1104,chelsea lfc,arsenal lfc,5,1,5,4,6,12,1,3,1,4,0,0,2,18,2,3,0,15,england,0,0,3.2,1.2,0,5,A,D,1,1,-16,-1,-15
1109,barnsley,luton,4,8,11,12,22,19,6,4,1,5,4,3,23,17,7,15,16,2,england,0,0,3.2,1.6,3,2,A,W,2,0,6,-8,14
1110,coventry city,wycombe wanderers,14,17,12,12,15,12,4,3,5,2,6,4,10,14,13,18,-3,-4,england,0,5,3.2,1.2,1,0,A,W,1,0,-4,-5,1
1111,port vale,lincoln,16,1,13,13,14,31,4,2,7,10,1,2,13,27,19,10,-6,17,england,4,0,2.83,1.16,2,6,H,L,0,4,-14,9,-23
1122,rochdale,bristol rovers,17,18,10,10,11,9,3,2,5,2,3,5,15,9,23,11,-8,-2,england,0,0,2.5,1.0,0,0,A,L,2,3,6,12,-6
1123,barnsley,plymouth,6,24,9,10,18,3,5,3,1,0,3,7,18,7,6,19,12,-12,england,0,0,2.83,1.16,1,1,A,D,0,0,11,-13,24
1124,cambridge,forest green,20,7,10,10,8,16,2,2,6,3,7,0,10,14,20,8,-10,6,england,3,0,3.33,1.83,1,3,A,L,2,5,-4,12,-16
1128,arsenal,wolverhampton,5,11,11,11,23,15,7,2,2,4,3,4,25,11,14,12,11,-1,england,3,5,2.5,1.5,1,1,A,W,3,0,14,2,12
1129,manchester united,manchester city,1,8,11,11,29,20,9,2,0,6,2,3,33,19,4,18,29,1,england,0,0,2.33,1.5,3,1,H,L,2,3,14,-14,28
1130,chelsea,everton,2,9,11,11,27,18,8,3,0,5,3,3,27,19,8,15,19,4,england,0,4,2.5,1.0,0,0,A,D,0,0,8,-7,15
1131,chelsea,crystal palace,3,14,10,10,24,8,7,3,0,2,2,6,24,7,7,13,17,-6,england,0,0,2.66,1.66,3,1,H,W,2,1,17,-6,23
1140,crystal palace,tottenham,14,4,11,11,8,24,2,2,7,8,0,3,8,19,16,10,-8,9,england,0,5,1.5,0.33,0,1,H,L,0,1,-11,6,-17
1146,liverpool,fulham,3,20,11,11,27,5,8,3,0,1,2,8,21,11,5,29,16,-18,england,0,4,3.16,1.66,2,0,A,W,3,2,10,-24,34
1162,manchester c,southampton,2,16,10,10,26,7,8,2,0,1,4,5,27,6,3,14,24,-8,england,0,4,3.16,1.0,6,1,A,W,1,0,21,-11,32
1164,wolverhampton,huddersfield,11,20,12,12,16,7,4,4,4,1,4,7,12,6,13,22,-1,-16,england,0,4,2.5,1.0,0,2,H,L,0,1,6,-9,15
1168,west ham united,manchester city,13,1,12,12,12,32,3,3,6,10,2,0,14,36,18,5,-4,31,england,3,6,4.0,2.16,0,4,H,L,1,4,-22,13,-35
1173,wolverhampton,tottenham,10,5,10,10,15,21,4,3,3,7,0,3,9,16,9,8,0,8,england,0,0,2.66,1.33,2,3,A,D,1,1,-7,1,-8
1177,afc bournemouth,arsenal,7,5,13,13,21,25,6,3,4,7,4,2,21,26,16,15,5,11,england,0,4,3.33,1.5,1,2,H,W,2,1,-5,1,-6
1181,tottenham,chelsea,4,3,12,12,27,28,9,0,3,8,4,0,20,27,10,8,10,19,england,0,0,3.66,1.83,3,1,A,W,3,1,-7,2,-9
1183,everton,cardiff,9,18,12,12,19,8,5,4,3,2,2,8,19,11,15,25,4,-14,england,0,0,1.5,0.0,1,0,H,W,2,1,8,-10,18
1186,arsenal,liverpool,4,2,10,10,22,26,7,1,2,8,2,0,24,20,13,4,11,16,england,0,0,4.5,1.83,1,1,H,D,3,3,4,9,-5
1192,leicester,burnley,10,15,11,11,16,8,5,1,5,2,2,7,17,12,16,25,1,-13,england,0,0,2.16,1.16,0,0,A,L,1,2,5,-9,14
1196,afc bournemouth,manchester united,6,8,10,10,20,17,6,2,2,5,2,3,19,17,12,17,7,0,england,0,4,2.66,1.33,1,2,H,L,0,2,2,-5,7
1215,burnley,newcastle united,17,15,12,12,9,9,2,3,7,2,3,7,12,9,25,15,-13,-6,england,0,0,2.75,1.0,1,2,A,D,1,1,3,10,-7
1220,newcastle united,afc bournemouth,17,6,11,11,6,20,1,3,7,6,2,3,7,20,14,14,-7,6,england,0,0,2.5,1.0,2,1,A,D,2,2,-13,0,-13
1229,southampton,watford,16,8,11,11,7,19,1,4,6,6,1,4,7,16,20,13,-13,3,england,0,0,3.0,1.5,1,1,H,W,1,0,-9,7,-16
1231,cardiff,leicester,17,12,10,10,5,13,1,2,7,4,1,5,9,16,23,16,-14,0,england,0,0,4.16,0.83,0,1,H,D,1,1,-7,7,-14
1238,huddersfield town,west ham united,18,13,11,11,6,11,1,3,7,3,2,6,5,13,21,17,-16,-4,england,3,0,3.5,1.0,1,1,H,L,1,4,-8,4,-12
1241,west ham,burnley,13,15,10,10,8,8,2,2,6,2,2,6,9,10,15,21,-6,-11,england,3,4,2.33,0.83,4,2,H,L,0,3,-1,-6,5
1247,fulham,southampton,20,17,13,13,6,9,1,3,9,1,6,6,13,10,33,23,-20,-13,england,0,0,3.0,1.5,3,2,H,L,0,1,3,10,-7
1259,newcastle,watford,19,7,10,10,3,19,0,3,7,6,1,3,6,16,14,12,-8,4,england,0,5,2.66,1.33,1,0,A,L,1,2,-10,2,-12
1282,cardiff,brighton,19,12,11,11,5,14,1,2,8,4,2,5,9,12,24,16,-15,-4,england,0,-4,1.66,1.16,2,1,A,L,0,1,-3,8,-11
1283,sheffield wednesday,sheffield united,3,17,16,16,29,19,9,2,5,5,4,7,27,21,19,30,8,-9,england,0,0,3.0,1.5,0,0,H,D,0,0,6,-11,17
1299,hull,norwich,23,1,18,18,16,36,4,4,10,11,3,4,16,32,26,21,-10,11,england,0,0,2.5,1.33,0,0,A,L,3,4,-16,5,-21
1326,leeds,reading,3,20,18,18,33,17,9,6,3,4,5,9,31,24,17,29,14,-5,england,0,0,2.16,0.83,1,0,A,D,2,2,7,-12,19
1354,aston villa,bolton,13,19,16,16,21,16,5,6,5,4,4,8,24,11,23,22,1,-11,england,0,0,2.0,0.83,2,0,H,W,2,0,13,1,12
1357,preston,middlesbrough,16,2,18,18,21,34,5,6,7,9,7,2,30,21,31,9,-1,12,england,0,0,3.5,1.0,1,1,H,L,5,6,9,22,-13
1366,ipswich,west bromwich,24,5,17,17,11,28,1,8,8,8,4,5,14,37,28,25,-14,12,england,0,0,2.16,0.5,1,2,H,W,1,0,-23,3,-26
1373,peterborough,luton,2,1,2,2,2,6,0,2,0,2,0,0,5,5,5,1,0,4,england,0,0,4.83,1.0,2,1,H,W,3,1,0,4,-4
1387,middlesbrough,wigan,4,16,16,16,28,20,7,7,2,6,2,8,17,19,8,24,9,-5,england,0,-4,1.33,0.66,2,0,H,W,1,0,-2,-16,14
1400,cardiff,wolverhampton,19,11,13,13,8,16,2,2,9,4,4,5,11,12,26,15,-15,-3,england,0,4,2.83,1.33,2,1,H,L,0,1,-1,11,-12
1402,sheffield w,bolton,18,22,18,18,20,17,5,5,8,4,5,9,22,12,32,24,-10,-12,england,0,0,3.0,1.16,1,0,H,D,1,1,10,8,2
1412,blackpool,accrington stanley,4,1,2,2,1,6,0,1,1,2,0,0,4,6,5,2,-1,4,england,0,-4,4.0,0.66,3,2,H,D,1,1,-2,3,-5
1423,derby,aston villa,5,14,16,16,28,21,8,4,4,5,6,5,25,24,17,23,8,1,england,0,0,2.16,1.0,0,3,A,D,1,1,1,-6,7
1424,birmingham,hull,8,23,17,17,26,15,6,8,3,4,3,10,22,14,18,23,4,-9,england,3,4,4.16,2.33,3,3,H,W,3,0,8,-5,13
1430,wigan,leeds,16,4,15,15,20,27,6,2,7,7,6,2,18,26,22,12,-4,14,england,0,0,1.66,0.83,1,2,H,D,1,1,-8,10,-18
1431,hull,west bromwich,23,5,16,16,13,26,3,4,9,7,5,4,12,33,21,23,-9,10,england,0,0,2.33,1.0,1,0,A,L,1,3,-21,-2,-19
1436,luton,bradford,3,24,20,20,38,14,11,5,4,4,2,14,38,15,21,35,17,-20,england,0,0,3.2,1.2,4,0,H,D,3,3,23,-14,37
1437,rotherham,queens pr,19,9,18,18,19,27,4,7,7,8,3,7,16,20,25,24,-9,-4,england,4,4,3.16,1.16,2,2,A,L,1,5,-4,1,-5
1456,notts county,doncaster,4,2,3,3,3,3,1,0,2,1,0,2,2,3,4,4,-2,-1,england,0,0,1.66,0.66,4,2,A,L,1,3,-1,0,-1
1466,blackburn rovers,rotherham united,9,19,17,17,26,18,6,8,3,4,6,7,19,13,20,22,-1,-9,england,0,4,2.33,1.0,1,1,A,D,1,1,6,-2,8
1492,stoke,derby,13,6,18,18,23,31,5,8,5,9,4,5,21,27,22,21,-1,6,england,0,0,2.16,1.0,2,1,A,W,2,0,-6,1,-7
1493,millwall,birmingham,21,12,18,18,17,24,4,5,9,5,9,4,23,25,30,24,-7,1,england,0,0,2.83,1.16,0,2,A,W,1,0,-2,6,-8
1494,wigan,blackburn,18,11,18,18,21,26,6,3,9,6,8,4,19,21,26,25,-7,-4,england,0,0,2.16,0.83,3,1,A,D,2,2,-2,1,-3
1495,aston villa,nottingham forest,9,7,18,18,27,30,7,6,5,7,9,2,31,25,25,16,6,9,england,0,0,3.5,1.0,5,5,A,W,1,0,6,9,-3
1498,peterborough united,afc wimbledon,4,23,20,20,36,15,10,6,4,4,3,13,35,14,24,29,11,-15,england,0,0,2.4,1.2,1,0,H,D,1,1,21,-5,26
1535,barnsley,bradford,2,4,2,2,5,2,1,1,0,0,1,1,3,2,2,5,1,-3,england,0,4,1.83,1.0,2,1,A,W,2,0,1,-3,4
1553,west bromwich,leeds,7,2,17,17,26,31,7,5,5,8,7,2,33,28,24,13,9,15,england,0,0,5.0,2.33,4,1,A,W,3,2,5,11,-6
1582,derby,birmingham,6,9,15,15,25,23,7,4,4,5,8,2,22,19,16,14,6,5,england,3,0,2.33,0.5,3,1,A,W,3,0,3,2,1
1587,ipswich,bristol city,24,16,18,18,11,22,1,8,9,6,4,8,15,20,30,21,-15,-1,england,0,4,2.83,1.16,2,3,A,L,0,1,-5,9,-14
1595,portsmouth,walsall,1,11,18,19,41,27,12,5,1,7,6,6,30,21,15,26,15,-5,england,0,0,2.0,0.5,2,0,A,W,1,0,9,-11,20
1617,hull,nottingham forest,23,7,18,18,16,30,4,4,10,7,9,2,16,25,26,16,-10,9,england,0,0,2.5,1.16,0,2,H,L,0,2,-9,10,-19
1634,coventry,peterborough,9,4,18,18,28,34,8,4,6,10,4,4,20,34,19,23,1,11,england,0,4,3.0,1.0,1,1,H,W,1,0,-14,-4,-10
1641,dartford,oxford city,7,17,16,16,27,18,8,3,5,5,3,8,20,23,21,24,-1,-1,england,3,0,3.66,1.16,3,2,H,L,1,4,-3,-3,0
1642,newport county,plymouth,2,4,3,3,6,0,2,0,1,0,0,3,5,0,1,10,4,-10,england,0,0,3.16,1.0,2,0,H,W,2,0,5,-9,14
1643,bury,fleetwood,3,4,2,2,3,1,1,0,1,0,1,1,3,2,3,4,0,-2,england,0,4,2.33,1.33,3,1,H,L,2,3,1,-1,2
1644,crewe,shrewsbury,3,1,3,3,3,8,1,0,2,2,1,0,5,8,8,1,-3,7,england,0,0,2.16,1.33,1,2,H,L,1,2,-3,7,-10
1720,sheffield w,norwich,16,4,15,15,19,27,5,4,6,8,3,4,21,20,26,17,-5,3,england,4,0,3.0,1.5,0,4,H,W,5,1,1,9,-8
1737,fleetwood town,coventry city,12,9,20,20,27,29,7,6,7,8,5,7,28,21,21,23,7,-2,england,3,4,2.0,0.0,3,0,H,W,3,0,7,-2,9
1738,oxford utd,rochdale,19,17,20,20,21,23,5,6,9,6,5,9,25,27,31,38,-6,-11,england,0,4,2.83,1.0,4,2,H,W,4,2,-2,-7,5
1739,sunderland,barnsley,2,3,18,18,37,35,10,7,1,10,5,3,35,32,16,15,19,17,england,0,0,2.0,0.5,4,2,H,L,0,1,3,1,2
1740,yeovil,port vale,18,17,18,20,22,23,5,7,6,6,5,9,23,17,19,23,4,-6,england,0,-4,3.16,1.0,0,3,A,D,1,1,6,-4,10
1741,newport county,northampton,3,14,20,20,33,24,9,6,5,5,9,6,28,24,31,25,-3,-1,england,0,4,3.33,2.16,3,1,A,L,0,1,4,6,-2
1742,forest green rovers,colchester united,10,3,19,19,30,32,7,9,3,9,5,5,28,32,19,19,9,13,england,0,0,4.5,2.5,0,1,H,L,1,2,-4,0,-4
1760,lincoln,mansfield,1,3,18,19,37,32,11,4,3,7,11,1,32,26,15,13,17,13,england,0,0,2.83,1.0,1,1,A,D,1,1,6,2,4
1822,nottingham forest,stoke,6,15,16,16,26,21,6,8,2,5,6,5,23,19,16,20,7,-1,england,0,0,1.6,0.6,0,0,H,W,3,2,4,-4,8
1826,queens park rangers,brentford,11,12,17,17,24,22,7,3,7,5,7,5,16,26,21,21,-5,5,england,0,4,3.5,1.5,3,2,A,L,1,2,-10,0,-10
1856,walsall,charlton,10,8,16,16,25,25,7,4,5,7,4,5,19,24,22,20,-3,4,england,0,0,2.66,1.5,0,2,A,L,1,3,-5,2,-7
1872,stoke,middlesbrough,15,3,16,16,21,28,5,6,5,7,7,2,19,17,20,8,-1,9,england,0,0,2.0,1.0,0,0,H,W,2,0,2,12,-10
1875,nottingham forest,sheffield u,7,1,15,15,23,29,5,8,2,9,2,4,22,27,16,18,6,9,england,0,0,2.16,1.16,1,0,A,D,0,0,-5,-2,-3
1888,arsenal,huddersfield,5,17,15,15,31,10,9,4,2,2,4,9,34,10,20,26,14,-16,england,0,4,3.0,0.75,1,0,A,W,1,0,24,-6,30
1889,everton,tottenham,11,3,17,17,24,39,6,6,5,13,0,4,24,31,22,16,2,15,england,4,0,2.66,1.16,2,6,A,L,0,4,-7,6,-13
1892,watford,manchester c,10,1,14,14,20,38,6,2,6,12,2,0,17,43,19,6,-2,37,england,0,6,3.66,1.66,1,2,A,L,1,3,-26,13,-39
1893,tottenham,burnley,3,17,16,16,36,12,12,0,4,3,3,10,30,15,16,32,14,-17,england,3,4,2.66,1.16,1,0,A,W,3,0,15,-16,31
1895,manchester c,everton,2,7,16,16,41,24,13,2,1,6,6,4,45,23,9,19,36,4,england,0,0,2.66,1.16,3,1,A,W,3,1,22,-10,32
1899,chelsea,manchester c,4,1,15,15,31,41,9,4,2,13,2,0,31,45,13,7,18,38,england,0,4,2.33,1.0,2,0,H,L,0,2,-14,6,-20
1901,leicester,manchester c,9,2,18,18,25,44,7,4,7,14,2,2,22,50,21,13,1,37,england,0,0,5.33,1.83,2,1,H,L,2,4,-28,8,-36
1906,burnley,liverpool,19,2,14,14,9,36,2,3,9,11,3,0,13,27,29,5,-16,22,england,0,4,2.16,1.16,1,3,H,L,1,2,-14,24,-38
1907,tottenham hotspur,afc bournemouth,3,8,18,18,42,26,14,0,4,8,2,8,37,27,18,28,19,-1,england,3,5,3.16,1.66,5,0,A,W,4,1,10,-10,20
1908,cardiff,manchester u,16,6,17,17,14,26,4,2,11,7,5,5,17,29,33,29,-16,0,england,0,0,3.0,2.0,1,5,A,L,0,2,-12,4,-16
1912,tottenham,southampton,5,18,14,14,30,9,10,0,4,1,6,7,25,12,15,26,10,-14,england,0,4,3.66,2.0,3,1,A,D,1,1,13,-11,24
1913,manchester u,arsenal,8,4,14,14,22,30,6,4,4,9,3,2,22,32,23,18,-1,14,england,0,0,3.16,1.5,2,2,H,W,2,1,-10,5,-15
1915,tottenham,wolverhampton,2,11,19,19,45,26,15,0,4,7,5,7,42,20,18,22,24,-2,england,0,0,3.33,1.5,1,3,A,W,3,2,22,-4,26
1916,manchester united,huddersfield town,6,19,18,18,29,10,8,5,5,2,4,12,34,11,30,31,4,-20,england,0,0,2.33,1.0,3,1,A,W,2,0,23,-1,24
1918,brighton and hove albion,chelsea,13,4,16,16,21,34,6,3,7,10,4,2,19,33,22,13,-3,20,england,4,0,3.33,1.66,1,2,H,L,0,4,-14,9,-23
1921,manchester united,afc bournemouth,6,12,19,19,32,26,9,5,5,8,2,9,37,27,31,33,6,-6,england,0,5,2.66,1.33,4,1,A,W,2,1,10,-2,12
1923,liverpool,newcastle,1,15,18,18,48,17,15,3,0,4,5,9,39,14,7,22,32,-8,england,0,0,2.16,1.0,4,0,H,W,2,0,25,-15,40
1926,chelsea,leicester,4,12,17,17,37,22,11,4,2,6,4,7,35,21,14,21,21,0,england,0,0,3.0,1.33,0,1,A,W,2,1,14,-7,21
1927,southampton,arsenal,19,5,16,16,9,34,1,6,9,10,4,2,13,35,30,20,-17,15,england,0,4,3.16,1.83,3,2,A,L,2,3,-22,10,-32
1932,wolverhampton,chelsea,13,3,14,14,16,31,4,4,6,9,4,1,13,30,17,11,-4,19,england,0,5,2.83,1.33,2,1,H,L,0,2,-17,6,-23
1934,watford,chelsea,7,4,18,18,27,37,8,3,7,11,4,3,25,35,25,15,0,20,england,3,0,4.16,1.33,1,2,H,W,4,1,-10,10,-20
1944,leicester,cardiff,7,17,19,19,28,15,8,4,7,4,3,12,24,18,22,38,2,-20,england,0,0,4.0,0.66,0,1,A,W,1,0,6,-16,22
1948,southampton,west ham,16,12,18,18,15,24,3,6,9,7,3,8,19,25,33,27,-14,-2,england,3,0,3.16,2.0,1,2,A,L,0,3,-6,6,-12
1949,brighton,arsenal,13,5,18,18,21,37,6,3,9,11,4,3,20,40,26,24,-6,16,england,0,0,3.75,2.0,1,1,H,W,2,1,-20,2,-22
1956,fulham,huddersfield town,19,20,19,19,11,10,2,5,12,2,4,13,17,12,43,34,-26,-22,england,0,0,2.83,2.0,1,0,A,L,0,1,5,9,-4
1958,crystal palace,cardiff,14,17,18,18,18,14,5,3,10,4,2,12,17,18,25,38,-8,-20,england,3,0,3.5,1.33,0,0,A,W,3,0,-1,-13,12
1960,burnley,everton,18,11,18,18,12,24,3,3,12,6,6,6,16,26,36,28,-20,-2,england,0,0,2.66,1.16,1,5,H,W,2,1,-10,8,-18
1963,everton,watford,7,13,15,15,23,20,6,5,4,6,2,7,21,18,17,21,4,-3,england,0,0,3.0,0.83,2,2,A,L,0,1,3,-4,7
1968,southampton,manchester c,17,3,19,19,15,44,3,6,10,14,2,3,20,51,35,15,-15,36,england,5,4,3.66,1.5,1,3,A,L,1,6,-31,20,-51
1978,wolverhampton wanderers,afc bournemouth,10,8,16,16,22,23,6,4,6,7,2,7,17,25,19,26,-2,-1,england,0,0,3.0,1.5,2,0,A,L,1,2,-8,-7,-1
1981,everton,newcastle,7,14,14,14,22,12,6,4,4,3,3,8,20,11,16,19,4,-8,england,0,5,2.33,0.83,1,1,H,W,1,0,9,-3,12
1983,brighton,crystal palace,11,14,14,14,18,12,5,3,6,3,3,8,16,10,20,17,-4,-7,england,0,0,2.16,1.33,3,1,A,L,2,3,6,3,3
1987,burnley,west ham,19,11,19,19,12,27,3,3,13,8,3,8,17,27,41,28,-24,-1,england,0,4,2.66,1.16,2,0,A,L,2,4,-10,13,-23
1988,fulham,wolverhampton,20,10,18,18,10,25,2,4,12,7,4,7,16,19,42,21,-26,-2,england,0,4,4.0,1.83,1,1,H,W,2,0,-3,21,-24
1992,wolverhampton,liverpool,10,1,18,18,25,48,7,4,7,15,3,0,19,39,21,7,-2,32,england,0,4,2.5,1.0,0,2,H,L,0,2,-20,14,-34
2001,crystal palace,burnley,15,18,14,14,12,9,3,3,8,2,3,9,9,13,17,28,-8,-15,england,0,0,2.33,1.33,2,0,H,W,1,0,-4,-11,7
2002,leeds,hull,1,15,24,24,51,30,15,6,3,8,6,10,42,28,22,33,20,-5,england,0,0,1.83,1.0,0,2,A,W,1,0,14,-11,25
2015,fulham,leicester,20,9,14,14,8,21,2,2,10,6,3,5,14,20,35,17,-21,3,england,0,0,5.0,1.4,1,1,A,L,3,4,-6,18,-24
2018,crystal palace,chelsea,15,4,19,19,19,40,5,4,10,12,4,3,17,37,25,16,-8,21,england,0,4,2.83,1.83,0,1,A,L,1,3,-20,9,-29
2023,crystal palace,leicester,16,9,16,16,12,22,3,3,10,6,4,6,13,21,23,20,-10,1,england,5,0,3.0,1.16,1,0,H,W,5,0,-8,3,-11
2030,newcastle,wolverhampton,15,13,15,15,13,19,3,4,8,5,4,6,12,15,20,18,-8,-3,england,0,4,2.83,1.66,1,2,A,W,1,0,-3,2,-5
2031,cardiff,southampton,16,18,15,15,11,9,3,2,10,1,6,8,14,13,30,29,-16,-16,england,0,0,2.16,1.16,1,0,A,W,1,0,1,1,0
2032,burnley,brighton,19,10,15,15,9,21,2,3,10,6,3,6,14,19,32,21,-18,-2,england,0,-5,1.33,1.0,1,0,H,D,0,0,-5,11,-16
2036,watford,newcastle,10,15,19,19,27,17,8,3,8,4,5,10,26,14,27,26,-1,-12,england,0,5,2.33,1.16,1,1,A,L,0,1,12,1,11
2043,huddersfield town,newcastle united,18,15,16,16,10,13,2,4,10,3,4,9,10,13,27,22,-17,-9,england,0,0,3.33,1.33,0,1,A,L,0,1,-3,5,-8
2050,west bromwich,sheffield w,3,16,24,24,45,30,13,6,5,8,6,10,52,30,31,40,21,-10,england,0,0,2.16,1.0,1,1,A,D,2,2,22,-9,31
2051,norwich,nottingham forest,2,7,23,23,47,35,14,5,4,8,11,4,41,32,26,23,15,9,england,0,4,2.83,1.0,3,3,A,W,2,1,9,3,6
2053,bournemouth,brighton,11,13,17,17,23,21,7,2,8,6,3,8,25,20,28,24,-3,-4,england,0,0,2.83,1.0,2,0,A,D,2,2,5,4,1
2076,leeds,blackburn,1,14,23,23,48,31,14,6,3,7,10,6,39,29,20,34,19,-5,england,0,4,2.5,0.83,3,2,A,L,1,2,10,-14,24
2080,west ham,watford,9,10,17,17,24,24,7,3,7,7,3,7,25,23,25,25,0,-2,england,0,0,3.0,1.66,0,2,H,W,2,0,2,0,2
2085,west ham united,crystal palace,13,15,15,15,18,12,5,3,7,3,3,9,20,11,23,20,-3,-9,england,0,0,3.0,1.66,3,2,H,D,1,1,9,3,6
2108,queens pr,reading,8,23,24,24,37,19,11,4,9,4,7,13,31,27,32,37,-1,-10,england,0,0,1.5,1.16,0,0,A,W,1,0,4,-5,9
2129,west bromwich,aston villa,3,8,20,20,35,31,10,5,5,8,7,5,42,39,28,30,14,9,england,0,0,2.33,1.33,2,2,H,D,0,0,3,-2,5
2135,huddersfield,brighton,17,12,14,14,11,16,2,5,7,4,4,6,9,15,23,20,-14,-5,england,0,0,2.33,1.83,1,2,A,D,1,1,-6,3,-9
2142,west bromwich,wigan,3,19,23,23,42,25,12,6,5,7,4,12,50,23,31,33,19,-10,england,0,0,3.0,1.66,2,0,A,L,0,1,27,-2,29
2150,derby,nottingham forest,5,7,21,21,37,34,11,4,6,8,10,3,31,32,24,22,7,10,england,0,0,1.83,0.66,0,0,A,D,0,0,-1,2,-3
2175,norwich,derby,2,6,24,24,48,39,14,6,4,11,6,7,44,33,29,28,15,5,england,0,0,2.16,0.66,3,4,A,D,1,1,11,1,10
2176,middlesbrough,ipswich,5,24,24,24,39,15,10,9,5,2,9,13,25,19,17,41,8,-22,england,0,4,2.5,1.16,2,0,A,W,2,0,6,-24,30
2177,swansea,wigan,13,19,24,24,32,25,9,5,10,7,4,13,29,23,28,35,1,-12,england,0,0,2.0,0.33,2,2,A,D,0,0,6,-7,13
2178,queens pr,ipswich,10,24,23,23,34,15,10,4,9,2,9,12,28,19,32,38,-4,-19,england,0,4,2.0,0.83,3,0,A,W,2,0,9,-6,15
2179,swansea,aston villa,12,11,23,23,32,33,9,5,9,8,9,6,29,45,27,37,2,8,england,0,5,2.0,0.83,0,1,A,L,0,1,-16,-10,-6
2180,bristol city,brentford,13,18,23,23,31,25,8,7,8,6,7,10,28,34,27,34,1,0,england,0,0,1.83,0.66,1,1,A,W,1,0,-6,-7,1
2181,birmingham,stoke,8,9,23,23,34,34,8,10,5,8,10,5,35,30,27,27,8,3,england,0,0,3.66,0.5,2,0,A,W,1,0,5,0,5
2196,bolton,leeds,23,2,21,21,18,42,4,6,11,12,6,3,15,35,29,18,-14,17,england,0,5,3.16,1.83,0,1,A,L,1,2,-20,11,-31
2213,bolton wanderers,rotherham united,23,20,23,23,18,22,4,6,13,4,10,9,15,22,31,37,-16,-15,england,0,0,4.0,1.2,2,1,A,D,1,1,-7,-6,-1
2234,bristol city,norwich,13,1,21,21,29,43,8,5,8,13,4,4,25,38,24,24,1,14,england,0,4,1.83,0.83,2,2,H,L,0,1,-13,0,-13
2235,aston villa,stoke,8,10,21,21,32,30,8,8,5,7,9,5,41,27,32,25,9,2,england,0,5,2.66,1.0,2,2,A,L,1,2,14,7,7
2244,norwich,bolton,1,23,20,20,40,18,12,4,4,4,6,10,35,13,22,26,13,-13,england,0,4,2.33,1.16,3,2,H,D,0,0,22,-4,26
2254,norwich city,rotherham united,1,20,20,20,40,20,12,4,4,4,8,8,35,19,22,30,13,-11,england,0,0,3.0,0.83,3,1,H,W,3,1,16,-8,24
2259,bristol city,rotherham,12,21,24,24,32,22,8,8,8,4,10,10,29,23,28,39,1,-16,england,0,0,2.16,0.83,1,0,A,D,0,0,6,-11,17
2260,birmingham,brentford,7,18,24,24,37,26,9,10,5,6,8,10,37,35,27,35,10,0,england,0,0,3.16,1.0,0,0,A,D,1,1,2,-8,10
2261,preston north end,aston villa,17,9,24,24,28,36,7,7,10,9,9,6,36,46,40,37,-4,9,england,0,0,3.2,1.8,1,1,A,D,3,3,-10,3,-13
2262,sunderland,shrewsbury town,3,18,22,24,46,28,13,7,2,7,7,10,43,28,22,31,21,-3,england,0,0,1.5,0.0,1,1,A,W,2,0,15,-9,24
2266,sheffield u,derby,6,5,23,23,38,39,11,5,7,11,6,6,36,32,27,25,9,7,england,0,0,2.16,1.33,3,1,A,L,1,2,4,2,2
2267,middlesbrough,sheffield w,4,17,23,23,39,27,10,9,4,7,6,10,25,29,16,40,9,-11,england,0,5,2.33,0.5,0,1,A,W,2,1,-4,-24,20
2268,millwall,reading,22,21,23,23,19,19,4,7,12,4,7,12,28,27,39,36,-11,-9,england,0,0,3.0,1.33,1,0,A,L,1,3,1,3,-2
2270,gillingham,portsmouth,19,1,23,23,25,51,7,4,12,15,6,2,33,39,38,19,-5,20,england,0,0,2.66,1.16,2,0,A,W,2,0,-6,19,-25
2278,blackburn,norwich,12,2,22,22,31,44,7,10,5,13,5,4,29,40,33,26,-4,14,england,0,0,4.0,1.5,0,1,A,D,2,2,-11,7,-18
2300,stoke,ipswich,12,24,20,20,27,11,6,9,5,1,8,11,25,17,25,35,0,-18,england,0,0,2.16,1.0,2,0,H,W,1,0,8,-10,18
2303,leeds,queens pr,2,11,20,20,39,28,11,6,3,8,4,8,33,24,17,29,16,-5,england,0,0,2.0,0.33,2,1,H,W,2,0,9,-12,21
2315,queens pr,hull,11,19,20,20,28,20,8,4,8,5,5,10,24,19,29,28,-5,-9,england,0,4,3.33,1.66,2,3,H,L,2,3,5,1,4
2318,bolton,stoke,22,11,24,24,21,34,5,6,13,8,10,6,17,30,32,29,-15,1,england,0,0,3.5,1.83,0,0,A,L,0,2,-13,3,-16
2319,millwall,nottingham forest,20,10,24,24,22,36,5,7,12,8,12,4,29,35,39,26,-10,9,england,0,0,1.83,0.83,1,0,A,D,2,2,-6,13,-19
2324,preston,hull,15,16,23,23,28,27,7,7,9,7,6,10,35,26,38,32,-3,-6,england,0,0,2.0,1.0,1,2,A,D,1,1,9,6,3
2325,crewe,lincoln,18,1,23,22,25,47,7,4,12,14,5,3,21,41,28,20,-7,21,england,0,0,2.83,0.83,2,1,A,L,0,1,-20,8,-28
2329,stoke,millwall,11,22,22,22,31,19,7,10,5,4,7,11,29,28,27,38,2,-10,england,0,5,1.66,1.0,1,0,H,W,2,0,1,-11,12
2333,derby,bristol city,4,14,22,22,38,30,11,5,6,8,6,8,31,27,24,26,7,1,england,0,0,3.66,1.5,1,1,H,D,0,0,4,-2,6
2353,ipswich,wigan,24,16,21,21,11,25,1,8,12,7,4,10,17,23,37,29,-20,-6,england,3,0,2.83,1.5,1,0,H,W,3,0,-6,8,-14
2354,queens pr,middlesbrough,14,6,21,21,28,36,8,4,9,9,9,3,25,23,31,14,-6,9,england,3,4,3.33,1.66,2,1,H,L,0,3,2,17,-15
2369,nottingham forest,preston,5,18,20,20,34,22,8,10,2,5,7,8,32,31,21,35,11,-4,england,3,0,1.83,0.83,0,1,H,L,0,3,1,-14,15
2391,bristol city,millwall,14,23,20,20,26,18,7,5,8,4,6,10,23,23,23,32,0,-9,england,0,0,1.83,0.83,1,1,A,L,0,2,0,-9,9
2394,reading,stoke,21,12,20,20,18,27,4,6,10,6,9,5,26,25,32,25,-6,0,england,0,0,4.16,0.83,2,2,H,D,2,2,1,7,-6
2395,nottingham forest,ipswich,5,24,20,20,34,11,8,10,2,1,8,11,32,17,21,35,11,-18,england,0,4,2.83,1.66,2,0,H,W,2,0,15,-14,29
2396,derby,swansea,7,13,20,20,34,26,10,4,6,7,5,8,30,22,24,21,6,1,england,0,0,2.0,0.66,2,1,H,W,2,1,8,3,5
2401,middlesbrough,aston villa,3,8,20,20,35,31,9,8,3,8,7,5,22,39,13,30,9,9,england,3,0,1.16,0.33,0,3,H,L,0,3,-17,-17,0
2412,sunderland,bradford city,3,20,21,23,43,21,12,7,2,6,3,14,42,24,22,39,20,-15,england,0,0,2.5,1.0,1,0,A,W,2,1,18,-17,35
2413,scunthorpe,luton,21,2,23,23,21,47,5,6,12,14,5,4,29,45,49,22,-20,23,england,0,0,5.0,2.5,0,2,A,L,2,3,-16,27,-43
2416,cheltenham,milton keynes dons,21,2,22,22,22,43,5,7,10,12,7,3,22,32,33,14,-11,18,england,3,4,6.0,1.8,3,1,A,L,0,3,-10,19,-29
2451,lincoln,morecambe,2,19,20,21,41,22,12,5,3,6,4,11,35,21,17,34,18,-13,england,0,0,2.5,1.0,3,1,A,D,0,0,14,-17,31
2457,hull,brentford,19,18,21,21,21,22,5,6,10,5,7,9,21,33,30,32,-9,1,england,0,0,2.83,1.33,2,0,A,D,1,1,-12,-2,-10
2458,blackburn,birmingham,11,9,21,21,30,30,7,9,5,7,9,5,27,30,31,25,-4,5,england,0,0,1.66,0.83,2,2,H,D,1,1,-3,6,-9
2471,portsmouth,charlton,1,7,20,20,47,34,14,5,1,10,4,6,34,32,15,24,19,8,england,0,0,1.33,0.83,1,2,H,L,0,1,2,-9,11
2483,portsmouth,southend,1,14,19,20,44,26,13,5,1,8,2,10,32,25,15,26,17,-1,england,0,5,2.66,1.66,2,0,A,L,1,3,7,-11,18
2495,birmingham,bristol city,9,14,20,20,30,26,7,9,4,7,5,8,30,24,24,24,6,0,england,0,4,2.5,1.66,0,1,A,L,1,3,6,0,6
2521,blackburn,sheffield w,10,16,20,20,29,23,7,8,5,6,5,9,26,25,30,36,-4,-11,england,0,0,3.33,1.66,4,2,H,W,4,2,1,-6,7
2522,bolton,wigan,23,15,20,20,18,25,4,6,10,7,4,9,13,23,26,28,-13,-5,england,0,0,2.66,0.83,1,1,H,D,1,1,-10,-2,-8
2523,birmingham,preston,9,17,20,20,30,22,7,9,4,5,7,8,30,31,24,35,6,-4,england,3,0,3.33,1.16,3,0,H,W,3,0,-1,-11,10
2536,tranmere,yeovil,8,21,24,22,37,23,10,7,7,5,8,9,37,26,31,27,6,-1,england,0,0,1.66,0.83,0,0,A,D,0,0,11,4,7
2539,sutton united,aldershot town,8,19,25,26,43,26,11,10,4,7,5,14,33,23,27,43,6,-20,england,0,0,2.5,1.0,2,1,A,L,1,2,10,-16,26
2541,fleetwood,portsmouth,10,1,24,24,33,51,9,6,9,15,6,3,33,39,25,21,8,18,england,0,0,2.8,0.8,2,5,A,L,0,1,-6,4,-10
2542,walsall,luton,14,2,24,24,31,50,8,7,9,15,5,4,25,47,37,22,-12,25,england,0,0,1.0,0.5,2,2,A,L,0,2,-22,15,-37
2543,colchester united,morecambe,4,20,24,24,41,25,12,5,7,7,4,13,36,26,25,40,11,-14,england,0,-4,1.4,1.0,0,0,A,W,1,0,10,-15,25
2544,cambridge,lincoln,22,1,24,23,23,47,6,5,13,14,5,4,21,42,39,22,-18,20,england,0,-4,0.66,0.66,1,2,A,D,1,1,-21,17,-38
2551,fleetwood town,doncaster rovers,12,7,23,23,30,39,8,6,9,11,6,6,30,39,25,28,5,11,england,4,0,1.5,1.16,3,0,A,W,4,0,-9,-3,-6
2552,coventry,charlton,14,4,23,23,29,43,8,5,10,13,4,6,23,38,28,25,-5,13,england,0,0,2.66,1.16,2,1,A,W,2,1,-15,3,-18
2553,walsall,bristol rovers,11,22,23,23,31,20,8,7,8,5,5,13,24,20,34,28,-10,-8,england,0,0,2.83,1.16,1,3,A,W,1,0,4,6,-2
2554,newport county,forest green,8,7,22,22,35,36,10,5,7,9,9,4,34,31,37,21,-3,10,england,0,0,3.66,2.0,1,4,A,D,1,1,3,16,-13
2556,harrogate town,halifax town,4,16,25,24,46,27,13,7,5,6,9,9,50,22,32,28,18,-6,england,3,0,2.33,0.83,1,2,H,L,0,3,28,4,24
2560,colchester,stevenage,3,12,23,23,41,32,12,5,6,9,5,9,35,28,23,30,12,-2,england,0,4,3.66,2.0,1,2,A,L,1,3,7,-7,14
2561,dagenham and redbridge,leyton orient,15,1,25,25,31,53,9,4,12,15,8,2,28,47,31,15,-3,32,england,0,0,2.0,0.66,2,1,H,D,0,0,-19,16,-35
2592,wigan,birmingham,16,10,22,22,25,31,7,4,11,7,10,5,23,32,30,27,-7,5,england,0,0,2.0,1.5,0,3,A,W,1,0,-9,3,-12
2593,rotherham,west bromwich,20,3,23,23,22,42,4,10,9,12,6,5,22,49,36,31,-14,18,england,0,0,4.0,1.0,0,4,A,L,3,4,-27,5,-32
2594,sheffield w,preston,18,15,22,22,24,28,6,6,10,7,7,8,28,35,40,37,-12,-2,england,3,0,2.66,0.33,1,0,H,W,4,1,-7,3,-10
2595,brentford,bolton wanderers,19,23,22,22,22,18,5,7,10,4,6,12,33,15,34,30,-1,-15,england,0,0,3.16,1.5,1,0,H,W,2,0,18,4,14
2596,reading,middlesbrough,21,6,22,22,19,36,4,7,11,9,9,4,27,24,35,16,-8,8,england,0,0,1.83,0.83,0,1,A,L,1,2,3,19,-16
2604,leyton orient,chesterfield,1,20,24,23,50,23,14,8,2,4,11,8,44,20,14,24,30,-4,england,0,0,2.0,0.66,3,1,A,W,1,0,24,-10,34
2605,peterborough,walsall,4,11,22,22,40,30,11,7,4,8,6,8,40,23,28,33,12,-10,england,0,0,2.16,0.83,1,1,H,W,2,1,17,-5,22
2606,burton albion,luton town,2,15,22,21,44,27,13,5,4,8,3,10,43,26,22,29,21,-3,england,0,0,1.0,0.0,2,0,H,L,0,1,17,-7,24
2636,bradford,walsall,24,10,21,21,15,30,4,3,14,8,6,7,18,23,39,29,-21,-6,england,0,0,3.0,0.83,4,0,H,D,1,1,-5,10,-15
2637,shrewsbury,peterborough,17,4,21,21,24,39,6,6,9,11,6,4,24,38,27,26,-3,12,england,0,0,3.16,0.83,2,2,H,W,3,1,-14,1,-15
2647,coventry,luton,11,2,21,21,29,41,8,5,8,12,5,4,22,41,25,21,-3,20,england,0,0,2.83,1.0,1,2,H,D,2,2,-19,4,-23
2650,swansea,sheffield w,12,17,21,21,29,24,8,5,8,6,6,9,25,27,23,38,2,-11,england,0,-4,1.0,0.5,2,1,H,W,2,0,-2,-15,13
2651,preston,millwall,15,21,21,21,25,19,6,7,8,4,7,10,32,26,35,35,-3,-9,england,0,0,1.5,0.83,3,2,A,D,1,1,6,0,6
2667,weston super mare,chelmsford,22,10,19,19,11,29,2,5,12,8,5,6,25,30,41,25,-16,5,england,0,0,2.0,1.0,0,3,A,W,1,0,-5,16,-21
2692,milton keynes dons,carlisle,1,11,20,20,40,27,11,7,2,8,3,9,30,25,13,25,17,0,england,3,0,2.5,1.0,2,0,A,L,0,3,5,-12,17
2693,luton,fleetwood,3,12,20,20,38,27,11,5,4,7,6,7,39,28,21,21,18,7,england,0,0,3.0,1.5,2,0,A,W,2,0,11,0,11
2708,boreham wood,leyton orient,11,1,22,23,28,50,7,7,8,14,8,1,23,44,25,13,-2,31,england,0,0,1.0,0.33,1,0,A,L,0,1,-21,12,-33
2712,mansfield,notts county,6,23,19,20,32,16,7,11,1,3,7,10,27,22,14,41,13,-19,england,0,4,3.0,0.66,2,0,A,D,1,1,5,-27,32
2761,brighton and hove albion,manchester united,20,2,38,38,31,81,6,13,19,25,6,7,31,68,56,28,-25,40,england,0,0,1.33,0.33,1,0,A,L,0,1,-37,28,-65
2769,west ham,manchester u,13,2,38,38,42,81,10,12,16,25,6,7,48,68,68,28,-20,40,england,4,4,3.5,1.0,0,0,H,W,4,0,-20,40,-60
2779,everton,southampton,8,17,38,38,49,36,13,10,15,7,15,16,44,37,58,56,-14,-19,england,3,0,2.5,1.0,1,1,A,L,1,4,7,2,5
2784,birmingham,fulham,19,3,46,46,46,88,13,7,26,25,13,8,38,79,68,46,-30,33,england,0,0,2.33,1.16,3,1,A,L,0,1,-41,22,-63
2804,manchester city,brighton and hove albion,1,20,38,38,100,31,32,4,2,6,13,19,106,31,27,56,79,-25,england,0,0,7.0,0.0,3,1,A,W,2,0,75,-29,104
2807,watford,newcastle,14,10,38,38,41,44,11,8,19,12,8,18,44,39,64,47,-20,-8,england,3,4,2.5,1.16,2,1,A,W,3,0,5,17,-12
2808,leicester,west ham,9,13,38,38,47,42,12,11,15,10,12,16,56,48,60,68,-4,-20,england,0,4,3.0,2.0,0,2,H,D,1,1,8,-8,16
2809,scunthorpe,plymouth,5,7,46,46,74,68,19,17,10,19,11,16,65,58,50,59,15,-1,england,4,5,2.33,0.5,2,0,H,L,0,4,7,-9,16
2926,swansea,stoke,18,19,38,38,33,33,8,9,21,7,12,19,28,35,56,68,-28,-33,england,0,0,2.66,1.33,1,2,A,L,1,2,-7,-12,5
2927,manchester u,watford,2,14,38,38,81,41,25,6,7,11,8,19,68,44,28,64,40,-20,england,0,5,3.5,1.5,1,0,A,W,4,2,24,-36,60
2935,derby,barnsley,6,22,46,46,75,41,20,15,11,9,14,23,70,48,48,72,22,-24,england,3,4,3.16,1.5,4,1,A,W,3,0,22,-24,46
2939,bournemouth,swansea,12,18,38,38,44,33,11,11,16,8,9,21,45,28,61,56,-16,-28,england,0,4,3.0,1.83,1,0,A,D,0,0,17,5,12
3012,bolton,nottingham forest,21,17,46,46,43,53,10,13,23,15,8,23,39,51,74,65,-35,-14,england,0,0,3.5,1.83,3,2,A,L,2,3,-12,9,-21
3013,millwall,aston villa,8,4,46,46,72,83,19,15,12,24,11,11,56,72,45,42,11,30,england,0,0,1.5,1.0,1,0,H,D,0,0,-16,3,-19
3014,preston north end,burton albion,7,23,46,46,73,41,19,16,11,10,11,25,57,38,46,81,11,-43,england,0,0,2.0,1.0,2,1,H,L,1,2,19,-35,54
3022,stoke,crystal palace,19,11,38,38,33,44,7,12,19,11,11,16,35,45,68,55,-33,-10,england,0,5,2.66,0.83,1,2,A,L,1,2,-10,13,-23
3029,doncaster rovers,afc wimbledon,15,18,46,46,56,53,13,17,16,13,14,19,52,47,52,58,0,-11,england,0,0,1.0,0.0,0,0,H,D,0,0,5,-6,11
3110,crystal palace,west bromwich,11,20,38,38,44,31,11,11,16,6,13,19,45,31,55,56,-10,-25,england,0,0,2.0,0.66,2,0,H,D,0,0,14,-1,15
3131,swindon,accrington stanley,9,1,46,46,68,93,20,8,18,29,6,11,67,76,65,46,2,30,england,3,4,2.33,1.16,3,0,H,W,3,0,-9,19,-28
3138,bradford,walsall,11,19,46,46,63,52,18,9,19,13,13,20,57,53,67,66,-10,-13,england,0,0,3.0,0.5,1,1,H,D,3,3,4,1,3
3219,birmingham,reading,5,4,18,18,30,32,9,3,6,9,5,4,30,40,18,18,12,22,england,0,0,1.66,0.66,1,1,A,W,2,0,-10,0,-10
3294,ipswich,middlesbrough,12,5,46,46,60,76,17,9,20,22,10,14,57,67,60,45,-3,22,england,0,0,2.5,1.16,2,2,H,D,2,2,-10,15,-25
3312,manchester c,liverpool,16,17,1,1,0,0,0,0,1,0,0,1,0,1,1,3,-1,-2,england,0,4,3.5,1.5,1,2,H,L,1,2,-1,-2,1
3620,huddersfield town,chelsea,9,7,0,0,0,0,0,0,0,0,0,0,0,0,0,0,0,0,england,0,0,3.25,1.25,0,3,A,D,1,1,0,0,0
3621,newcastle,tottenham,14,16,0,0,0,0,0,0,0,0,0,0,0,0,0,0,0,0,england,0,4,3.33,0.83,1,2,A,L,0,1,0,0,0
3622,newcastle,chelsea,15,4,2,2,1,6,0,1,1,2,0,0,1,6,2,2,-1,4,england,3,4,3.66,1.83,1,2,A,L,0,3,-5,0,-5
3623,brighton and hove albion,manchester united,16,10,1,1,0,3,0,0,1,1,0,0,0,2,2,1,-2,1,england,0,0,1.33,0.33,3,2,A,L,0,1,-2,1,-3
3624,manchester u,tottenham,9,6,2,2,3,6,1,0,1,2,0,0,4,5,4,2,0,3,england,0,0,2.16,1.0,0,3,H,W,2,1,-1,2,-3
3627,liverpool,west ham,11,14,0,0,0,0,0,0,0,0,0,0,0,0,0,0,0,0,england,3,0,3.5,1.33,4,0,A,L,1,4,0,0,0
3628,wolverhampton,manchester c,14,1,2,2,1,6,0,1,1,2,0,0,2,8,4,1,-2,7,england,3,5,4.66,1.5,1,1,H,W,4,1,-6,3,-9
3629,crystal palace,liverpool,8,7,1,1,3,3,1,0,0,1,0,0,2,4,0,0,2,4,england,0,5,3.0,1.33,0,2,H,L,1,2,-2,0,-2
3631,west ham united,afc bournemouth,20,3,1,1,0,3,0,0,1,1,0,0,0,2,4,0,-4,2,england,0,0,4.16,1.16,1,2,A,D,1,1,-2,4,-6
3632,everton,southampton,9,12,1,1,1,1,0,1,0,0,1,0,2,0,2,0,0,0,england,0,0,2.66,0.83,2,1,H,D,1,1,2,2,0
3633,arsenal,west ham,17,19,2,2,0,0,0,0,2,0,0,2,2,1,5,6,-3,-5,england,3,4,3.5,1.0,3,1,A,L,1,4,1,-1,2
3637,liverpool,brighton,2,11,2,2,6,3,2,0,0,1,0,1,6,3,0,4,6,-1,england,4,4,5.0,2.0,1,0,A,L,0,4,3,-4,7
3646,birmingham,swansea,19,4,2,2,1,6,0,1,1,2,0,0,2,3,3,1,-1,2,england,0,0,3.0,1.0,0,0,H,L,1,2,-1,2,-3
3647,watford,brighton,17,13,0,0,0,0,0,0,0,0,0,0,0,0,0,0,0,0,england,0,0,1.5,0.5,2,0,A,L,0,1,0,0,0
3656,huddersfield,cardiff,20,16,2,2,0,1,0,0,2,0,1,1,1,0,9,2,-8,-2,england,3,5,3.16,1.83,0,0,A,W,3,0,1,7,-6
3659,leeds,rotherham,2,13,2,2,6,3,2,0,0,1,0,1,7,2,2,5,5,-3,england,3,0,2.0,0.66,2,0,H,W,3,0,5,-3,8
3665,southampton,leicester,13,8,2,2,1,3,0,1,1,1,0,1,1,3,2,2,-1,1,england,0,0,2.16,1.33,1,2,H,D,0,0,-2,0,-2
3667,derby,ipswich,9,23,4,4,6,2,2,0,2,0,2,2,6,3,7,6,-1,-3,england,0,0,1.83,1.0,2,0,H,W,2,0,3,1,2
3670,hull,aston villa,17,16,0,0,0,0,0,0,0,0,0,0,0,0,0,0,0,0,england,0,0,1.83,1.33,1,3,H,D,0,0,0,0,0
3675,rotherham united,hull city,21,16,4,4,3,4,1,0,3,1,1,2,4,5,10,7,-6,-2,england,0,0,7.0,2.25,2,3,H,L,2,3,-1,3,-4
3684,queens pr,bristol city,24,11,4,4,0,5,0,0,4,1,2,1,2,6,13,5,-11,1,england,3,0,2.0,0.83,0,3,H,L,0,3,-4,8,-12
3692,leeds,middlesbrough,1,2,5,5,13,13,4,1,0,4,1,0,14,9,4,2,10,7,england,3,0,1.83,1.0,0,0,A,L,0,3,5,2,3
3714,middlesbrough,sheffield u,12,19,1,1,1,0,0,1,0,0,0,1,2,1,2,2,0,-1,england,0,0,1.5,0.83,3,0,A,L,1,2,1,0,1
3729,middlesbrough,west bromwich,2,7,4,4,10,7,3,1,0,2,1,1,8,13,2,7,6,6,england,0,4,2.16,1.16,1,0,H,D,1,1,-5,-5,0
3755,bolton,birmingham,6,18,4,4,8,3,2,2,0,0,3,1,5,2,3,3,2,-1,england,0,4,0.83,0.83,1,0,A,W,1,0,3,0,3
3756,norwich,preston,21,14,4,4,2,5,0,2,2,1,2,1,6,3,8,3,-2,0,england,0,0,1.83,0.5,2,0,H,D,0,0,3,5,-2
3781,sheffield w,millwall,16,15,4,4,4,5,1,1,2,1,2,1,5,4,6,5,-1,-1,england,0,0,3.0,1.16,2,1,A,L,1,2,1,1,0
3791,ipswich town,aston villa,20,4,2,2,1,6,0,1,1,2,0,0,2,6,3,3,-1,3,england,4,0,2.0,0.6,1,1,A,W,4,0,-4,0,-4
3792,bristol city,middlesbrough,14,1,2,3,2,7,0,2,0,2,1,0,3,6,3,2,0,4,england,0,5,2.33,1.0,0,2,A,L,1,2,-3,1,-4
3793,notts county,yeovil,18,20,2,2,1,1,0,1,1,0,1,1,2,2,3,3,-1,-1,england,3,0,2.0,0.66,0,4,H,W,4,1,0,0,0
3814,birmingham,norwich,3,13,0,0,0,0,0,0,0,0,0,0,0,0,0,0,0,0,england,0,0,2.0,1.16,2,2,A,W,2,0,0,0,0
3831,norwich,leeds,15,2,4,4,4,10,1,1,2,3,1,0,8,11,8,4,0,7,england,0,0,4.33,1.66,0,3,A,L,1,2,-3,4,-7
3832,derby,preston,11,18,4,4,6,4,2,0,2,1,1,2,6,3,7,5,-1,-2,england,0,4,1.33,0.33,2,0,A,W,1,0,3,2,1
3845,brentford,sheffield w,11,20,2,2,4,1,1,1,0,0,1,1,6,3,2,4,4,-1,england,0,0,2.83,1.5,2,0,A,L,0,2,3,-2,5
3860,millwall,derby,15,11,2,2,2,3,0,2,0,1,0,1,2,3,2,5,0,-2,england,0,0,2.66,1.33,2,1,A,D,0,0,-1,-3,2
3861,reading,bolton,24,7,2,2,0,4,0,0,2,1,1,0,1,4,3,3,-2,1,england,0,-4,2.0,1.0,0,1,A,D,1,1,-3,0,-3
3880,queens pr,sheffield u,20,24,1,2,0,0,0,0,1,0,0,2,0,1,1,5,-1,-4,england,0,0,2.5,1.33,1,2,A,L,1,2,-1,-4,3
3899,bristol city,nottingham forest,7,14,0,0,0,0,0,0,0,0,0,0,0,0,0,0,0,0,england,0,4,2.0,1.16,1,1,A,D,0,0,0,0,0
3927,swansea,bristol city,7,13,4,4,8,5,2,2,0,1,2,1,5,6,3,5,2,1,england,0,0,0.83,0.5,0,1,H,L,0,2,-1,-2,1
3930,blackburn rovers,brentford,9,5,4,4,6,8,1,3,0,2,2,0,5,10,4,4,1,6,england,0,0,3.5,2.33,1,0,A,W,3,1,-5,0,-5
3931,queens pr,wigan,24,8,4,4,0,7,0,0,4,2,1,1,2,10,13,7,-11,3,england,0,4,1.33,0.66,1,0,A,L,1,2,-8,6,-14
3943,afc wimbledon,walsall,12,5,4,4,5,10,1,2,1,3,1,0,2,8,3,4,-1,4,england,0,0,3.4,1.6,1,3,A,W,3,1,-6,-1,-5
4024,nottingham forest,birmingham,10,20,4,4,6,2,1,3,0,0,2,2,5,2,4,4,1,-2,england,0,0,1.83,0.83,2,2,A,L,1,2,3,0,3
4025,sheffield w,ipswich,17,21,4,4,4,2,1,1,2,0,2,2,5,3,7,6,-2,-3,england,0,0,2.66,0.83,2,1,A,W,2,1,2,1,1
4058,charlton,peterborough,11,1,3,3,4,9,1,1,1,3,0,0,4,9,4,3,0,6,england,3,0,3.66,0.83,0,1,A,L,1,4,-5,1,-6
4059,colchester,crewe,3,16,4,4,8,4,2,2,0,1,1,2,9,6,1,7,8,-1,england,6,0,3.16,1.16,6,0,H,W,6,0,3,-6,9
4060,lincoln,bury,2,17,4,4,10,4,3,1,0,1,1,2,8,3,3,4,5,-1,england,0,0,2.33,0.83,2,1,H,W,2,1,5,-1,6
4166,west ham,chelsea,17,3,5,5,3,15,1,0,4,5,0,0,5,14,11,4,-6,10,england,0,0,2.66,1.0,0,0,A,D,1,1,-9,7,-16
4168,burnley,manchester u,19,14,3,3,1,3,0,1,2,1,0,2,3,4,7,7,-4,-3,england,0,0,1.83,1.16,0,2,A,W,1,0,-1,0,-1
4170,arsenal,everton,9,12,5,5,9,6,3,0,2,1,3,1,10,8,9,9,1,-1,england,4,5,4.16,2.5,2,0,H,W,5,1,2,0,2
4172,brighton and hove albion,tottenham hotspur,13,5,6,6,5,12,1,2,3,4,0,2,8,12,11,7,-3,5,england,0,0,2.25,0.5,1,2,H,D,1,1,-4,4,-8
4173,leicester,liverpool,7,1,3,3,6,9,2,0,1,3,0,0,5,7,3,0,2,7,england,0,0,3.5,1.5,1,2,A,L,1,2,-2,3,-5
4174,manchester city,brighton and hove albion,2,13,6,6,16,5,5,1,0,1,2,3,19,8,3,11,16,-3,england,0,0,6.0,1.0,2,0,H,W,3,1,11,-8,19
4178,chelsea,afc bournemouth,3,6,3,3,9,7,3,0,0,2,1,0,8,6,3,3,5,3,england,3,5,3.16,1.33,2,0,A,W,3,0,2,0,2
4179,manchester c,newcastle,5,16,3,3,7,1,2,1,0,0,1,2,9,2,2,4,7,-2,england,0,4,3.5,1.66,2,1,H,W,3,1,7,-2,9
4180,west ham,manchester u,17,7,6,6,4,10,1,1,4,3,1,2,5,9,11,9,-6,0,england,0,0,3.0,1.0,3,1,H,D,0,0,-4,2,-6
4184,watford,tottenham,5,4,3,3,9,9,3,0,0,3,0,0,7,8,2,2,5,6,england,0,5,2.83,1.83,2,1,A,L,0,2,-1,0,-1
4194,huddersfield town,tottenham hotspur,20,5,6,6,2,12,0,2,4,4,0,2,3,12,14,7,-11,5,england,0,0,3.0,2.0,0,2,A,L,0,2,-9,7,-16
4197,watford,manchester u,3,10,4,4,12,6,4,0,0,2,0,2,9,6,3,7,6,-1,england,0,5,2.83,1.16,1,2,A,L,0,1,3,-4,7
4198,newcastle,arsenal,18,9,4,4,1,6,0,1,3,2,0,2,3,8,6,8,-3,0,england,0,5,2.33,1.0,1,2,A,L,1,2,-5,-2,-3
4207,wolverhampton,burnley,12,19,4,4,5,1,1,2,1,0,1,3,4,3,5,9,-1,-6,england,0,0,2.0,0.66,1,0,H,D,1,1,1,-4,5
4209,tottenham,liverpool,5,1,4,4,9,12,3,0,1,4,0,0,9,9,4,1,5,8,england,0,0,3.0,1.5,1,2,H,D,2,2,0,3,-3
4215,manchester c,fulham,4,13,4,4,10,4,3,1,0,1,1,2,11,7,3,9,8,-2,england,5,5,3.83,1.5,3,0,H,W,5,0,4,-6,10
4217,everton,huddersfield,8,19,3,3,5,1,1,2,0,0,1,2,6,1,5,9,1,-8,england,0,0,3.33,1.33,1,1,H,L,0,2,5,-4,9
4221,everton,fulham,12,15,6,6,6,5,1,3,2,1,2,3,8,8,11,13,-3,-5,england,0,4,3.5,1.16,3,0,A,W,3,1,0,-2,2
4226,leicester,huddersfield,11,18,5,5,6,2,2,0,3,0,2,3,8,2,9,11,-1,-9,england,3,0,2.5,0.83,3,1,H,W,3,0,6,-2,8
4228,fulham,watford,15,4,5,5,4,12,1,1,3,4,0,1,7,10,12,5,-5,5,england,0,0,2.66,1.33,1,1,H,L,0,1,-3,7,-10
4248,burnley,bournemouth,20,5,5,5,1,10,0,1,4,3,1,1,3,10,10,7,-7,3,england,0,0,3.0,1.0,4,0,H,L,1,2,-7,3,-10
4252,cardiff,burnley,19,12,7,7,2,7,0,2,5,2,1,4,4,9,16,11,-12,-2,england,0,-4,2.16,0.66,1,2,H,L,1,2,-5,5,-10
4261,wolverhampton,southampton,10,14,6,6,9,5,2,3,1,1,2,3,6,6,6,9,0,-3,england,0,0,2.33,1.16,2,0,A,W,2,0,0,-3,3
4284,leeds,preston,1,23,7,7,15,5,4,3,0,1,2,4,15,7,5,12,10,-5,england,0,0,2.66,1.5,3,0,H,L,0,2,8,-7,15
4291,sheffield w,leeds,10,1,9,9,14,18,4,2,3,5,3,1,14,19,14,7,0,12,england,0,0,2.16,0.66,1,1,A,W,2,1,-5,7,-12
4298,bournemouth,leicester,6,8,4,4,7,6,2,1,1,2,0,2,6,6,5,5,1,1,england,0,-5,1.16,0.66,4,2,H,D,1,1,0,0,0
4326,crystal palace,southampton,10,17,3,3,3,1,1,0,2,0,1,2,3,2,4,4,-1,-2,england,0,4,3.0,1.33,0,2,A,W,2,1,1,0,1
4327,brighton and hove albion,fulham,12,11,3,3,3,3,1,0,2,1,0,2,3,5,5,7,-2,-2,england,0,5,3.16,0.83,2,2,H,L,1,2,-2,-2,0
4347,middlesbrough,bolton,4,12,7,7,14,11,4,2,1,3,2,2,9,9,3,10,6,-1,england,0,6,2.5,1.16,2,0,H,W,2,0,0,-7,7
4373,wigan athletic,bristol city,8,5,8,8,13,14,4,1,3,4,2,2,13,14,11,10,2,4,england,0,0,2.0,0.5,1,0,H,L,0,1,-1,1,-2
4377,lincoln city fc,crawley town,1,16,6,6,16,7,5,1,0,2,1,3,14,8,4,10,10,-2,england,0,0,2.0,0.5,0,1,H,L,1,3,6,-6,12
4406,west bromwich,bristol city,8,3,7,7,11,14,3,2,2,4,2,1,16,12,10,6,6,6,england,0,0,3.33,0.5,4,2,H,W,1,0,4,4,0
4416,birmingham,west bromwich,20,9,6,6,4,10,0,4,2,3,1,2,4,15,6,9,-2,6,england,0,0,2.83,0.83,1,1,H,L,1,2,-11,-3,-8
4430,birmingham,ipswich,17,23,9,9,9,5,1,6,2,0,5,4,7,6,8,12,-1,-6,england,0,0,2.0,0.83,2,2,H,W,1,0,1,-4,5
4446,millwall,leeds,16,1,6,6,5,14,1,2,3,4,2,0,6,14,8,4,-2,10,england,0,4,2.66,1.0,1,1,H,W,4,3,-8,4,-12
4451,barnsley,walsall,3,5,6,6,14,14,4,2,0,4,2,0,14,10,3,5,11,5,england,0,4,3.33,1.33,1,1,H,W,3,1,4,-2,6
4455,maidenhead utd,eastleigh,18,17,8,8,8,9,2,2,4,3,0,5,11,7,14,13,-3,-6,england,0,4,4.16,1.66,2,0,H,W,3,1,4,1,3
4469,brentford,reading,7,20,9,9,15,8,4,3,2,2,2,5,16,12,10,13,6,-1,england,0,0,3.33,1.16,2,2,A,W,1,0,4,-3,7
4470,bolton,derby,15,6,9,9,12,16,3,3,3,5,1,3,9,13,12,10,-3,3,england,3,5,3.0,1.5,1,0,A,L,0,3,-4,2,-6
4501,ipswich,brentford,24,2,7,7,3,14,0,3,4,4,2,1,5,14,11,6,-6,8,england,0,0,2.5,0.83,1,1,H,L,0,1,-9,5,-14
4502,wigan,hull,11,17,7,7,10,7,3,1,3,2,1,4,11,8,10,11,1,-3,england,0,4,3.83,1.0,2,1,H,W,3,2,3,-1,4
4541,hull,middlesbrough,21,2,9,9,7,18,2,1,6,5,3,1,9,11,16,3,-7,8,england,0,4,3.16,1.83,1,1,A,L,1,3,-2,13,-15
4572,stoke,swansea,20,6,7,7,6,12,1,3,3,3,3,1,9,7,13,5,-4,2,england,0,0,2.83,1.83,1,0,H,W,2,1,2,8,-6
4573,derby,blackburn,7,13,7,7,12,10,4,0,3,2,4,1,10,8,9,9,1,-1,england,0,0,2.0,0.66,0,0,H,L,0,1,2,0,2
4582,norwich,middlesbrough,18,2,6,6,5,14,1,2,3,4,2,0,9,9,12,2,-3,7,england,0,0,1.83,1.5,1,0,H,W,1,0,0,10,-10
4583,rotherham,derby,15,4,6,6,6,12,2,0,4,4,0,2,5,10,11,8,-6,2,england,0,0,3.5,1.0,1,0,H,D,1,1,-5,3,-8
4599,exeter,notts county,9,24,6,6,10,1,3,1,2,0,1,5,8,6,6,16,2,-10,england,0,0,3.16,1.66,5,1,H,W,2,1,2,-10,12
4604,dover athletic,ebbsfleet united,22,9,8,8,4,13,1,1,6,4,1,3,9,10,19,7,-10,3,england,0,0,2.5,1.33,1,1,H,L,1,2,-1,12,-13
4606,derby count,23 - leicester city-u23,8,1,4,4,5,9,1,2,1,3,0,1,4,7,5,2,-1,5,england,0,4,2.6,1.0,0,2,H,L,0,2,-3,3,-6
4618,millwall,swansea,16,10,5,5,5,8,1,2,2,2,2,1,5,5,6,4,-1,1,england,0,0,3.0,1.33,1,2,A,W,2,0,0,2,-2
4620,hull,derby,19,6,5,5,4,9,1,1,3,3,0,2,5,8,9,7,-4,1,england,4,4,3.0,2.0,1,2,H,L,0,4,-3,2,-5
4639,swansea,queens pr,14,16,9,9,13,10,3,4,2,3,1,5,7,7,6,15,1,-8,england,0,0,3.16,1.0,3,0,A,D,1,1,0,-9,9
4641,blackburn,nottingham forest,12,9,9,9,14,14,3,5,1,3,5,1,11,11,11,9,0,2,england,0,0,2.66,1.5,2,2,A,W,1,0,0,2,-2
4646,preston,west bromwich,24,3,9,9,5,17,1,2,6,5,2,2,9,22,18,12,-9,10,england,0,0,2.83,1.5,2,3,A,L,2,3,-13,6,-19
4759,wrexham,halifax town,1,4,8,8,17,16,5,2,1,5,1,2,13,13,4,6,9,7,england,0,0,1.5,1.33,0,0,H,D,1,1,0,-2,2
4777,notts county,forest green,24,12,5,5,1,7,0,1,4,1,4,0,5,7,13,4,-8,3,england,0,0,2.66,0.66,1,3,A,W,2,1,-2,9,-11
4778,peterborough,doncaster,1,7,5,5,15,8,5,0,0,2,2,1,15,6,4,3,11,3,england,0,0,1.83,1.0,1,1,A,D,1,1,9,1,8
